CDRB=Code Rebel Corporation
FCLF=First Clover Leaf Financial Corp.
DISCB=Discovery Communications, Inc.
BBBY=Bed Bath & Beyond Inc.
BYLK=Baylake Corp
SPAN=Spa
FORTY=Formula Systems (1985) Ltd.
SEDG=SolarEdge Technologies, Inc.
XNCR=Xencor, Inc.
EEML=iShares MSCI Emerging Markets Latin America Index Fun
FBIZ=First Business Financial Services, Inc.
CASS=Cass Information Systems, Inc
ISSC=Innovative Solutions and Support, Inc.
ODFL=Old Dominion Freight Line, Inc.
VXUP=AccuShares Spot CBOE VIX Up Share
CHCI=Comstock Holding Companies, Inc.
SSYS=Stratasys, Ltd.
ZIOP=ZIOPHARM Oncology Inc
MAR=Marriott International
ATSG=Air Transport Services Group, Inc
SIBC=State Investors Bancorp, Inc.
CSFL=CenterState Banks, Inc.
TUTI=Tuttle Tactical Management Mult
AGNCB=American Capital Agency Corp.
TOPS=TOP Ships Inc.
ICBK=County Bancorp, Inc.
WINA=Winmark Corporation
SGC=Superior Uniform Group, Inc.
SPTN=SpartanNash Company
YRCW=YRC Worldwide, Inc.
ABCW=Anchor BanCorp Wisconsin Inc.
MPET=Magellan Petroleum Corporation
JAGX=Jaguar Animal Health, Inc.
LMCK=Liberty Media Corporation
FREE=FreeSeas Inc.
TRUE=TrueCar, Inc.
MKSI=MKS Instruments, Inc.
ABAC=Aoxin Tianli Group, Inc.
RUSHA=Rush Enterprises, Inc.
PRGX=PRGX Global, Inc.
FMI=Foundation Medicine, Inc.
RGNX=REGENXBIO Inc.
TRNS=Transcat, Inc.
CLMS=Calamos Asset Management, Inc.
BITI=Biotie Therapies Corp.
TANH=Tantech Holdings Ltd.
RVLT=Revolution Lighting Technologies, Inc.
IPCM=IPC Healthcare, Inc.
IFGL=iShares FTSE EPRA/NAREIT Global Real Estate e
FNLC=First Bancorp, Inc (ME)
AQXP=Aquinox Pharmaceuticals, Inc.
AMSGP=Amsurg Corp.
MLHR=Herman Miller, Inc.
PFMT=Performant Financial Corporation
BNTCW=Benitec Biopharma Limited
QNST=QuinStreet, Inc.
FGM=First Trust Germany AlphaDEX Fun
ABTL=Autobytel Inc.
FRPH=FRP Holdings, Inc.
SEMI=SunEdison Semiconductor Limited
CACQ=Caesars Acquisition Company
WTFCM=Wintrust Financial Corporation
FNWB=First Northwest Bancorp
GPRO=GoPro, Inc.
DAX=Recon Capital DAX Germany ET
FSBK=First South Bancorp Inc
GUID=Guidance Software, Inc.
SFST=Southern First Bancshares, Inc.
SIVB=SVB Financial Group
SBLK=Star Bulk Carriers Corp.
ICON=Iconix Brand Group, Inc.
FCCO=First Community Corporation
AXPWW=Axion Power International, Inc.
CSTE=CaesarStone Sdo
UCTT=Ultra Clean Holdings, Inc.
PZZA=Papa John's International, Inc.
SHOS=Sears Hometown and Outlet Stores, Inc.
ANCB=Anchor Bancorp
DWTR=PowerShares DWA Tactical Sector Rotation Portfoli
QPAC=Quinpario Acquisition Corp. 2
GPRE=Green Plains, Inc.
XELB=Xcel Brands, Inc
STX=Seagate Technology.
FONR=Fonar Corporation
FFIV=F5 Networks, Inc.
WOWO=Wowo Limited
AFFX=Affymetrix, Inc.
PAGG=PowerShares Global Agriculture Portfoli
BYBK=Bay Bancorp, Inc.
GCBC=Greene County Bancorp, Inc.
AFAM=Almost Family Inc
TACOW=Del Taco Restaurants, Inc.
FTNT=Fortinet, Inc.
NVET=Nexvet Biopharma plc
QURE=uniQure N.V.
ALTR=Altera Corporation
ICLD=InterCloud Systems, Inc
PICO=PICO Holdings Inc.
CYOU=Changyou.com Limited
QQEW=First Trust NASDA
ZYNE=Zynerba Pharmaceuticals, Inc.
INCY=Incyte Corporation
CLRO=ClearOne, Inc.
CRMT=America's Ca
EVK=Eve
BLMT=BSB Bancorp, Inc.
ROIAK=Radio One, Inc.
DSPG=DSP Group, Inc.
GMAN=Gordmans Stores, Inc.
BELFA=Bel Fuse Inc.
ACST=Acasti Pharma, Inc.
GBIM=GlobeImmune, Inc.
LMNX=Luminex Corporation
FTW=First Trust Taiwan AlphaDEX Fun
CATY=Cathay General Bancorp
AAPC=Atlantic Alliance Partnership Corp.
UFCS=United Fire Group, Inc
MEILZ=Methes Energies International Ltd
LOXO=Loxo Oncology, Inc.
AMED=Amedisys Inc
GYRO=Gyrodyne , LLC
ESRX=Express Scripts Holding Company
WATT=Energous Corporation
GNBC=Green Bancorp, Inc.
PLPM=Planet Payment, Inc.
MOFG=MidWestOne Financial Group, Inc.
CERCZ=Cerecor Inc.
MYOK=MyoKardia, Inc.
DRNA=Dicerna Pharmaceuticals, Inc.
ADRD=BLDRS Developed Markets 100 ADR Index Fun
OFLX=Omega Flex, Inc.
RARE=Ultragenyx Pharmaceutical Inc.
DEST=Destination Maternity Corporation
BUR=Burcon NutraScience Corp
ARTNA=Artesian Resources Corporation
EVEP=EV Energy Partners, L.P.
SNAK=Inventure Foods, Inc.
PRXI=Premier Exhibitions, Inc.
VUSE=Vident Core US Equity ET
GOODO=Gladstone Commercial Corporation
AVGR=Avinger, Inc.
JGBB=WisdomTree Japan Interest Rate Strategy Fun
STAA=STAAR Surgical Company
FMER=FirstMerit Corporation
LPLA=LPL Financial Holdings Inc.
CNYD=China Yida Holding, Co.
CTRL=Control4 Corporation
VIDI=Vident International Equity Fun
CLBS=Caladrius Biosciences, Inc.
COSI=Cosi, Inc.
ARDM=Aradigm Corporation
NAVI=Navient Corporation
CLNE=Clean Energy Fuels Corp.
GROW=U.S. Global Investors, Inc.
OVLY=Oak Valley Bancorp (CA)
ACIW=ACI Worldwide, Inc.
TCRD=THL Credit, Inc.
LBIX=Leading Brands Inc
XRAY=DENTSPLY International Inc.
AGND=WisdomTree Barclays U.S. Aggregate Bond Negative Duration Fun
SANM=Sanmina Corporation
GILT=Gilat Satellite Networks Ltd.
VMBS=Vanguard Mortgag
DSCO=Discovery Laboratories, Inc.
AMBCW=Ambac Financial Group, Inc.
SHPG=Shire plc
OBCI=Ocean Bi
CHSCM=CHS Inc
OFIX=Orthofix International N.V.
CNLM=CB Pharma Acquisition Corp.
WEB=Web.com Group, Inc.
EMCF=Emclaire Financial Corp
TGA=Transglobe Energy Corp
BLIN=Bridgeline Digital, Inc.
IVTY=Invuity, Inc.
OTIC=Otonomy, Inc.
EPIQ=EPIQ Systems, Inc.
PSCM=PowerShares S&P SmallCap Materials Portfoli
ECACU=
LMOS=Lumos Networks Corp.
XONE=The ExOne Company
MTSC=MTS Systems Corporation
VIAB=Viacom Inc.
HAYN=Haynes International, Inc.
TTEC=TeleTech Holdings, Inc.
DGICB=Donegal Group, Inc.
QIWI=QIWI plc
MAGS=Magal Security Systems Ltd.
CVLT=CommVault Systems, Inc.
UBOH=United Bancshares, Inc.
CAMB=Cambridge Capital Acquisition Corporation
BCPC=Balchem Corporation
PNBK=Patriot National Bancorp Inc.
VNET=21Vianet Group, Inc.
WING=Wingstop Inc.
DMLP=Dorchester Minerals, L.P.
AMCC=Applied Micro Circuits Corporation
HART=Harvard Apparatus Regenerative Technology, Inc.
NRCIB=National Research Corporation
AAME=Atlantic American Corporation
FFWM=First Foundation Inc.
LALT=PowerShares Mult
EFOI=Energy Focus, Inc.
XXIA=Ixia
KBSF=KBS Fashion Group Limited
REDF=Rediff.com India Limited
JCOM=j2 Global, Inc.
CNLMW=CB Pharma Acquisition Corp.
PLKI=Popeyes Louisiana Kitchen, Inc.
FCCY=1st Constitution Bancorp (NJ)
EMCI=EMC Insurance Group Inc.
FFIC=Flushing Financial Corporation
TACT=TransAct Technologies Incorporated
LMAT=LeMaitre Vascular, Inc.
HIIQ=Health Insurance Innovations, Inc.
ENTG=Entegris, Inc.
TCBK=TriCo Bancshares
BHBK=Blue Hills Bancorp, Inc.
CHEF=The Chefs' Warehouse, Inc.
DFVL=Barclays PLC
EBIO=Eleven Biotherapeutics, Inc.
ADBE=Adobe Systems Incorporated
UG=Unite
CDOR=Condor Hospitality Trust, Inc.
TICC=TICC Capital Corp.
QLYS=Qualys, Inc.
UPLD=Upland Software, Inc.
PKOH=Par
PMD=Psychemedics Corporation
UNIS=Unilife Corporation
OIIM=O2Micro International Limited
SLMAP=SLM Corporation
PTC=PTC Inc.
BBSI=Barrett Business Services, Inc.
HWAY=Healthways, Inc.
EGOV=NIC Inc.
CMRX=Chimerix, Inc.
USMD=USMD Holdings, Inc.
KONA=Kona Grill, Inc.
AFCB=Athens Bancshares Corporation
SORL=SORL Auto Parts, Inc.
ULBI=Ultralife Corporation
CCCL=China Ceramics Co., Ltd.
CHKE=Cherokee Inc.
ALLT=Allot Communications Ltd.
FDUS=Fidus Investment Corporation
GALTU=Galectin Therapeutics Inc.
SCHL=Scholastic Corporation
RDIB=Reading International Inc
AWRE=Aware, Inc.
LXRX=Lexicon Pharmaceuticals, Inc.
CLSN=Celsion Corporation
ARWA=Arowana Inc.
GFN=General Finance Corporation
BRKR=Bruker Corporation
VIIZ=Credit Suisse AG
ATRI=ATRION Corporation
CRME=Cardiome Pharma Corporation
HBCP=Home Bancorp, Inc.
SAMG=Silvercrest Asset Management Group Inc.
RELL=Richardson Electronics, Ltd.
AAL=American Airlines Group, Inc.
BOTA=Biota Pharmaceuticals, Inc.
CHFN=Charter Financial Corp.
LTBR=Lightbridge Corporation
APRI=Apricus Biosciences, Inc
CRWN=Crown Media Holdings, Inc.
SEIC=SEI Investments Company
NXPI=NXP Semiconductors N.V.
IMDZ=Immune Design Corp.
IFEU=iShares FTSE EPRA/NAREIT Europe Index Fun
NTES=NetEase, Inc.
KEQU=Kewaunee Scientific Corporation
FBNK=First Connecticut Bancorp, Inc.
INVT=Inventergy Global, Inc.
TFSC=1347 Capital Corp.
RENT=Rentrak Corporation
NEOS=Neos Therapeutics, Inc.
SBGI=Sinclair Broadcast Group, Inc.
HCACU=Hennessy Capital Acquisition Corp. II
QBAK=Qualstar Corporation
IDTI=Integrated Device Technology, Inc.
IPHS=Innophos Holdings, Inc.
CFNB=California First National Bancorp
LLEX=Lilis Energy, Inc.
FCTY=1st Century Bancshares, Inc
GEOS=Geospace Technologies Corporation
AAWW=Atlas Air Worldwide Holdings
CHOP=China Gerui Advanced Materials Group Limited
SZYM=Solazyme, Inc.
GLBS=Globus Maritime Limited
YNDX=Yandex N.V.
APOG=Apogee Enterprises, Inc.
ETSY=Etsy, Inc.
PBIB=Porter Bancorp, Inc.
CRDC=Cardica, Inc.
PFBI=Premier Financial Bancorp, Inc.
TWMC=Trans World Entertainment Corp.
LGCYP=Legacy Reserves LP
AFOP=Alliance Fiber Optic Products, Inc.
SALM=Salem Media Group, Inc.
AGTC=Applied Genetic Technologies Corporation
PCH=Potlatch Corporation
GOLD=Randgold Resources Limited
FORM=FormFactor, Inc.
NSEC=National Security Group, Inc.
PRAN=Prana Biotechnology Ltd
SCON=Superconductor Technologies Inc.
GALT=Galectin Therapeutics Inc.
PCAR=PACCAR Inc.
ESGR=Enstar Group Limited
EAGLW=Double Eagle Acquisition Corp.
BPMC=Blueprint Medicines Corporation
PACEU=Pace Holdings Corp.
QADA=QAD Inc.
CSII=Cardiovascular Systems, Inc.
FELE=Franklin Electric Co., Inc.
TCBIP=Texas Capital Bancshares, Inc.
CLBH=Carolina Bank Holdings Inc.
CACB=Cascade Bancorp
VTWV=Vanguard Russell 2000 Value ET
KERX=Keryx Biopharmaceuticals, Inc.
MDSO=Medidata Solutions, Inc.
LGCY=Legacy Reserves LP
FMB=First Trust Managed Municipal ET
SPRO=SmartPros Ltd.
PERI=Perion Network Ltd
UACL=Universal Truckload Services, Inc.
MELR=Melrose Bancorp, Inc.
FEUZ=First Trust Eurozone AlphaDEX ET
LNCO=Linn Co, LLC
MEET=MeetMe, Inc.
BBLU=Blue Earth, Inc.
PGTI=PGT, Inc.
COHU=Cohu, Inc.
FNHC=Federated National Holding Company
JAZZ=Jazz Pharmaceuticals plc
LPTH=LightPath Technologies, Inc.
ZIV=Credit Suisse AG
OPHT=Ophthotech Corporation
WYIGU=JM Global Holding Company
FCS=Fairchild Semiconductor International, Inc.
MTGE=American Capital Mortgage Investment Corp.
CVLY=Codorus Valley Bancorp, Inc
ZN=Zion Oil & Gas Inc
NLST=Netlist, Inc.
CBAY=CymaBay Therapeutics Inc.
ISIG=Insignia Systems, Inc.
RELY=Real Industry, Inc.
PLAB=Photronics, Inc.
UCFC=United Community Financial Corp.
TCBI=Texas Capital Bancshares, Inc.
IMMY=Imprimis Pharmaceuticals, Inc.
FLXN=Flexion Therapeutics, Inc.
DGRS=WisdomTree U.S. SmallCap Quality Dividend Growth Fun
FSC=Fifth Street Finance Corp.
FULL=Full Circle Capital Corporation
STRT=Strattec Security Corporation
AKAO=Achaogen, Inc.
LGND=Ligand Pharmaceuticals Incorporated
AIRR=First Trust RBA American Industrial Renaissance ET
QSII=Quality Systems, Inc.
HRMNW=Harmony Merger Corp.
AMSWA=American Software, Inc.
NHTC=Natural Health Trends Corp.
ALCO=Alico, Inc.
INTX=Intersections, Inc.
YDIV=First Trust International Mult
FFIN=First Financial Bankshares, Inc.
KTOS=Kratos Defense & Security Solutions, Inc.
CBMG=Cellular Biomedicine Group, Inc.
DISCK=Discovery Communications, Inc.
SWSH=Swisher Hygiene, Inc.
ASUR=Asure Software Inc
ALGN=Align Technology, Inc.
LMCB=Liberty Media Corporation
RJET=Republic Airways Holdings, Inc.
BECN=Beacon Roofing Supply, Inc.
SPSC=SPS Commerce, Inc.
THTI=THT Heat Transfer Technology, Inc.
RECN=Resources Connection, Inc.
CLCT=Collectors Universe, Inc.
RLYP=Relypsa, Inc.
FCVT=First Trust SSI Strategic Convertible Securities ET
PDBC=PowerShares DB Optimum Yield Diversified Commodity Strategy Portfoli
VICR=Vicor Corporation
WTFC=Wintrust Financial Corporation
LSCC=Lattice Semiconductor Corporation
PERF=Perfumania Holdings, Inc
DTSI=DTS, Inc.
VNDA=Vanda Pharmaceuticals Inc.
PTNR=Partner Communications Company Ltd.
GTXI=GTx, Inc.
PHIIK=PHI, Inc.
VWOB=Vanguard Emerging Markets Government Bond ET
GFNSL=General Finance Corporation
PRQR=ProQR Therapeutics N.V.
OTIV=On Track Innovations Ltd
LPCN=Lipocine Inc.
PHMD=PhotoMedex, Inc.
PACE=Pace Holdings Corp.
FHCO=Female Health Company (The)
PEGI=Pattern Energy Group Inc.
RMGN=RMG Networks Holding Corporation
GLMD=Galmed Pharmaceuticals Ltd.
ANGO=AngioDynamics, Inc.
KIN=Kindred Biosciences, Inc.
USLV=Credit Suisse AG
NATI=National Instruments Corporation
CORT=Corcept Therapeutics Incorporated
BCOV=Brightcove Inc.
ACXM=Acxiom Corporation
OESX=Orion Energy Systems, Inc.
MAT=Mattel, Inc.
CBAK=China BAK Battery, Inc.
FLAT=Barclays PLC
BWINA=Baldwin & Lyons, Inc.
PDLI=PDL BioPharma, Inc.
LDRH=LDR Holding Corporation
AVGO=Avago Technologies Limited
TEDU=Tarena International, Inc.
EBSB=Meridian Bancorp, Inc.
CHTR=Charter Communications, Inc.
FCSC=Fibrocell Science Inc
SSFN=Stewardship Financial Corp
ZAGG=ZAGG Inc
BDSI=BioDelivery Sciences International, Inc.
TERP=TerraForm Power, Inc.
ITIC=Investors Title Company
WRLD=World Acceptance Corporation
CORE=Cor
ISSI=Integrated Silicon Solution, Inc.
QLTI=QLT Inc.
ASMB=Assembly Biosciences, Inc.
BHACW=Barington/Hilco Acquisition Corp.
AYA=Amaya Inc.
MPAA=Motorcar Parts of America, Inc.
CFFN=Capitol Federal Financial, Inc.
AFMD=Affimed N.V.
CME=CME Group Inc.
WMAR=West Marine, Inc.
STEM=StemCells, Inc.
MBLX=Metabolix, Inc.
MRCC=Monroe Capital Corporation
SOCL=Global X Social Media Index ET
MSLI=Merus Labs International Inc.
NTLS=NTELOS Holdings Corp.
CAKE=The Cheesecake Factory Incorporated
MCEP=Mi
IMGN=ImmunoGen, Inc.
JJSF=J & J Snack Foods Corp.
INSM=Insmed, Inc.
STRS=Stratus Properties, Inc.
DXJS=WisdomTree Japan Hedged SmallCap Equity Fun
ELOS=Syneron Medical Ltd.
SMT=SMART Technologies Inc.
HFBC=HopFed Bancorp, Inc.
SIGI=Selective Insurance Group, Inc.
ITCI=Intr
TOR=Sutor Technology Group Limited
GHDX=Genomic Health, Inc.
HSNI=HSN, Inc.
FLXS=Flexsteel Industries, Inc.
NVSL=Naugatuck Valley Financial Corporation
VTWO=Vanguard Russell 2000 ET
SIMO=Silicon Motion Technology Corporation
THLD=Threshold Pharmaceuticals, Inc.
HDSN=Hudson Technologies, Inc.
TTWO=Tak
CSGS=CSG Systems International, Inc.
RXII=RXi Pharmaceuticals Corporation
LQDT=Liquidity Services, Inc.
EXPE=Expedia, Inc.
BDCV=BDCA Venture, Inc.
ALSK=Alaska Communications Systems Group, Inc.
CMPR=Cimpress N.V
IRWD=Ironwood Pharmaceuticals, Inc.
CSA=Victory CEMP US Small Cap Volatility Wtd Index ET
CIZ=Victory CEMP Developed Enhanced Volatility Wtd Index ET
METR=Metro Bancorp, Inc
PERY=Perry Ellis International Inc.
ATLO=Ames National Corporation
SVA=Sinovac Biotech, Ltd.
ALOT=Astr
AVEO=AVEO Pharmaceuticals, Inc.
REXX=Rex Energy Corporation
INTU=Intuit Inc.
XENE=Xenon Pharmaceuticals Inc.
VRA=Vera Bradley, Inc.
MASI=Masimo Corporation
SKYS=Sky Solar Holdings, Ltd.
JACK=Jack In The Box Inc.
SPLS=Staples, Inc.
BNSO=Bonso Electronics International, Inc.
HMSY=HMS Holdings Corp
ZAIS=ZAIS Group Holdings, Inc.
LMFAU=LM Funding America, Inc.
PLCM=Polycom, Inc.
ENG=ENGlobal Corporation
CTXS=Citrix Systems, Inc.
PCTI=P
HBMD=Howard Bancorp, Inc.
ENOC=EnerNOC, Inc.
FTSM=First Trust Enhanced Short Maturity ET
BUSE=First Busey Corporation
TZOO=Travelzoo Inc.
CLNT=Cleantech Solutions International, Inc.
DELTW=Delta Technology Holdings Limited
NVEC=NVE Corporation
CRDT=WisdomTree Strategic Corporate Bond Fun
CYTK=Cytokinetics, Incorporated
HTCH=Hutchinson Technology Incorporated
YLCO=Global X Yieldco Index ET
CACC=Credit Acceptance Corporation
FPA=First Trust Asia Pacific E
AMCX=AMC Networks Inc.
ABIO=ARCA biopharma, Inc.
CCUR=Concurrent Computer Corporation
CHI=Calamos Convertible Opportunities and Income Fund
AGEN=Agenus Inc.
FTRPR=Frontier Communications Corporation
ASTE=Astec Industries, Inc.
SHOR=ShoreTel, Inc.
NRCIA=National Research Corporation
AMGN=Amgen Inc.
RDCM=Radcom Ltd.
MRNS=Marinus Pharmaceuticals, Inc.
EMMS=Emmis Communications Corporation
ADUS=Addus HomeCare Corporation
BEBE=bebe stores, inc.
DWCH=Datawatch Corporation
CNMD=CONMED Corporation
MXWL=Maxwell Technologies, Inc.
CNAT=Conatus Pharmaceuticals Inc.
PPHM=Peregrine Pharmaceuticals Inc.
HRTX=Heron Therapeutics, Inc.
AUDC=AudioCodes Ltd.
KNDI=Kandi Technologies Group, Inc.
FBMS=The First Bancshares, Inc.
CTRV=ContraVir Pharmaceuticals Inc
ROIC=Retail Opportunity Investments Corp.
HYND=WisdomTree BofA Merrill Lynch High Yield Bond Negative Duration Fun
DRYS=DryShips Inc.
KMDA=Kamada Ltd.
ORRF=Orrstown Financial Services Inc
LIVE=Live Ventures Incorporated
RXDX=Ignyta, Inc.
APPS=Digital Turbine, Inc.
DATE=Jiayuan.com International Ltd.
SABR=Sabre Corporation
UBIC=UBIC, Inc.
PEGA=Pegasystems Inc.
NSTG=NanoString Technologies, Inc.
MFLX=Mult
NTIC=Northern Technologies International Corporation
BANX=StoneCastle Financial Corp
RUN=Sunrun Inc.
EQIX=Equinix, Inc.
NK=NantKwest, Inc.
CPXX=Celator Pharmaceuticals Inc.
AXAS=Abraxas Petroleum Corporation
SMTC=Semtech Corporation
PWX=Providence and Worcester Railroad Company
ADXS=Advaxis, Inc.
DRWI=DragonWave Inc
PBIP=Prudential Bancorp, Inc.
CLMT=Calumet Specialty Products Partners, L.P.
FGEN=FibroGen, Inc
STFC=State Auto Financial Corporation
QDEL=Quidel Corporation
HIFS=Hingham Institution for Savings
SAEX=SAExploration Holdings, Inc.
UBFO=United Security Bancshares
TOWN=Towne Bank
EBMT=Eagle Bancorp Montana, Inc.
GDEN=Golden Entertainment, Inc.
TENX=Tenax Therapeutics, Inc.
FOSL=Fossil Group, Inc.
AMCN=AirMedia Group Inc
HFWA=Heritage Financial Corporation
MSFT=Microsoft Corporation
NXTM=NxStage Medical, Inc.
STNR=Steiner Leisure Limited
ISRG=Intuitive Surgical, Inc.
EFSC=Enterprise Financial Services Corporation
MENT=Mentor Graphics Corporation
HOMB=Home BancShares, Inc.
ATAI=ATA Inc.
BOOM=Dynamic Materials Corporation
NUVA=NuVasive, Inc.
SIFY=Sify Technologies Limited
MYGN=Myriad Genetics, Inc.
PRFZ=PowerShares FTSE RAFI US 1500 Smal
TESO=Tesco Corporation
GGACW=Garnero Group Acquisition Company
IBB=iShares Nasdaq Biotechnology Index Fun
HBP=Huttig Building Products, Inc.
SNSS=Sunesis Pharmaceuticals, Inc.
CNLMU=CB Pharma Acquisition Corp.
BIOC=Biocept, Inc.
TBNK=Territorial Bancorp Inc.
BKSC=Bank of South Carolina Corp.
ODP=Office Depot, Inc.
YECO=Yulong Ec
SCYX=SCYNEXIS, Inc.
WYIG=JM Global Holding Company
TGTX=TG Therapeutics, Inc.
AKTX=Akari Therapeutics Plc
OMCL=Omnicell, Inc.
VTNR=Vertex Energy, Inc
KVHI=KVH Industries, Inc.
ICLDW=InterCloud Systems, Inc
NYMTO=New York Mortgage Trust, Inc.
CCMP=Cabot Microelectronics Corporation
BRKL=Brookline Bancorp, Inc.
PBMD=Prima BioMed Ltd
ITUS=ITUS Corporation
SRPT=Sarepta Therapeutics, Inc.
ABEOW=Abeona Therapeutics Inc.
PDII=PDI, Inc.
PANL=Pangaea Logistics Solutions Ltd.
PESI=Perm
SNHY=Sun Hydraulics Corporation
HSGX=Histogenics Corporation
CYTR=CytRx Corporation
AIMC=Altra Industrial Motion Corp.
QABA=First Trust NASDAQ ABA Community Bank Index Fun
APPY=Venaxis, Inc.
LABL=Mult
RNWK=RealNetworks, Inc.
CTHR=Charles & Colvard Ltd
ANGI=Angie's List, Inc.
BABY=Natus Medical Incorporated
SMIT=Schmitt Industries, Inc.
APTO=Aptose Biosciences, Inc.
FEYE=FireEye, Inc.
SPU=SkyPeople Fruit Juice, Inc.
INTLL=INTL FCStone Inc.
SMLR=Semler Scientific, Inc.
ENFC=Entegra Financial Corp.
HEAR=Turtle Beach Corporation
KTEC=Key Technology, Inc.
MRVC=MRV Communications, Inc.
DLBL=Barclays PLC
JASN=Jason Industries, Inc.
FIBK=First Interstate BancSystem, Inc.
CNCR=Loncar Cancer Immunotherapy ET
RICK=RCI Hospitality Holdings, Inc.
GDEF=Global Defense & National Security Systems, Inc.
HCAP=Harvest Capital Credit Corporation
HQY=HealthEquity, Inc.
TXRH=Texas Roadhouse, Inc.
TSYS=TeleCommunication Systems, Inc.
VCLT=Vanguard Lon
BHACU=Barington/Hilco Acquisition Corp.
FTEK=Fuel Tech, Inc.
TEAR=TearLab Corporation
QPACU=Quinpario Acquisition Corp. 2
HTBX=Heat Biologics, Inc.
DAKT=Daktronics, Inc.
GNOW=American Caresource Holdings Inc
BIND=BIND Therapeutics, Inc.
WEBK=Wellesley Bancorp, Inc.
EDUC=Educational Development Corporation
SIEN=Sientra, Inc.
GAINN=Gladstone Investment Corporation
NXTD=NX
TKAI=Tokai Pharmaceuticals, Inc.
FSCFL=Fifth Street Finance Corp.
VTIP=Vanguard Shor
IMMR=Immersion Corporation
GBNK=Guaranty Bancorp
ATRA=Atara Biotherapeutics, Inc.
CPRX=Catalyst Pharmaceuticals, Inc.
AMIC=American Independence Corp.
SHEN=Shenandoah Telecommunications Co
MNRK=Monarch Financial Holdings, Inc.
BLBD=Blue Bird Corporation
MOCO=MOCON, Inc.
NEWS=NewStar Financial, Inc.
IMNP=Immune Pharmaceuticals Inc.
CADC=China Advanced Construction Materials Group, Inc.
NGHCP=National General Holdings Corp
ASML=ASML Holding N.V.
AXDX=Accelerate Diagnostics, Inc.
HDRAW=Hydra Industries Acquisition Corp.
CHKP=Check Point Software Technologies Ltd.
XLNX=Xilinx, Inc.
INTG=The Intergroup Corporation
EXEL=Exelixis, Inc.
FTGC=First Trust Global Tactical Commodity Strategy Fun
DNKN=Dunkin' Brands Group, Inc.
SGMS=Scientific Games Corp
DSKX=DS Healthcare Group, Inc.
HCKT=The Hackett Group, Inc.
GCVRZ=Sanofi
ONTX=Onconova Therapeutics, Inc.
ZXYZ.A=Nasdaq Symbology Test Common Stoc
AXGN=AxoGen, Inc.
MDVN=Medivation, Inc.
UEIC=Universal Electronics Inc.
MBRG=Middleburg Financial Corporation
FISV=Fiserv, Inc.
HDS=HD Supply Holdings, Inc.
FKO=First Trust South Korea AlphaDEX Fun
OVTI=OmniVision Technologies, Inc.
INO=Inovio Pharmaceuticals, Inc.
CADTU=DT Asia Investments Limited
SQNM=Sequenom, Inc.
TFSCU=1347 Capital Corp.
SAFT=Safety Insurance Group, Inc.
MLVF=Malvern Bancorp, Inc.
CPST=Capstone Turbine Corporation
CAPX=Elkhorn S&P 500 Capital Expenditures Portfoli
MB=MINDBODY, Inc.
FRSH=Papa Murphy's Holdings, Inc.
CA=CA Inc.
QTEC=First Trust NASDA
HBHCL=Hancock Holding Company
SBBP=Strongbridge Biopharma plc
FHK=First Trust Hong Kong AlphaDEX Fun
PTIE=Pain Therapeutics
ZFGN=Zafgen, Inc.
NNBR=NN, Inc.
JOUT=Johnson Outdoors Inc.
CYAD=Celyad SA
CWBC=Community West Bancshares
OXLC=Oxford Lane Capital Corp.
SREV=ServiceSource International, Inc.
VSEC=VSE Corporation
SYNC=Synacor, Inc.
BOFI=BofI Holding, Inc.
CHDN=Churchill Downs, Incorporated
ISHG=iShares S&P/Citigroup
ORLY=O'Reilly Automotive, Inc.
CYTX=Cytori Therapeutics Inc
GIGA=Gig
SOXX=iShares PHLX SOX Semiconductor Sector Index Fun
FDIV=First Trust Strategic Income ET
ADXSW=Advaxis, Inc.
ARRY=Array BioPharma Inc.
GRFS=Grifols, S.A.
XBIT=XBiotech Inc.
MELA=MELA Sciences, Inc
GNTX=Gentex Corporation
BRID=Bridgford Foods Corporation
CPTA=Capitala Finance Corp.
RNVA=Rennova Health, Inc.
TUES=Tuesday Morning Corp.
SRNE=Sorrento Therapeutics, Inc.
ZIONZ=Zions Bancorporation
CUI=CUI Global, Inc.
BSF=Bear State Financial, Inc.
JBLU=JetBlue Airways Corporation
STRA=Strayer Education, Inc.
RKDA=Arcadia Biosciences, Inc.
ZWZZT=NASDAQ TEST STOC
IIVI=I
SSNC=SS&C Technologies Holdings, Inc.
DISH=DISH Network Corporation
TAX=Liberty Tax, Inc.
BBEP=Breitburn Energy Partners LP
TASR=TASER International, Inc.
BSRR=Sierra Bancorp
PSUN=Pacific Sunwear of California, Inc.
AIXG=Aixtron SE
WYNN=Wynn Resorts, Limited
EYEG=Eyegate Pharmaceuticals, Inc.
CUTR=Cutera, Inc.
HBNC=Horizon Bancorp (IN)
WMIH=WMIH Corp.
OFS=OFS Capital Corporation
CVGI=Commercial Vehicle Group, Inc.
SKYW=SkyWest, Inc.
CONN=Conn's, Inc.
QINC=First Trust RBA Quality Income ET
VRTA=Vestin Realty Mortgage I, Inc.
FARO=FARO Technologies, Inc.
TST=TheStreet, Inc.
ACGL=Arch Capital Group Ltd.
STMP=Stamps.com Inc.
CCIH=ChinaCache International Holdings Ltd.
RCMT=RCM Technologies, Inc.
CFCB=Centrue Financial Corporation
EDAP=EDAP TMS S.A.
UBSI=United Bankshares, Inc.
PTCT=PTC Therapeutics, Inc.
GRID=First Trust NASDAQ Clean Edge Smart Grid Infrastructure Index Fun
AIRM=Air Methods Corporation
HFFC=HF Financial Corp.
GENC=Gencor Industries Inc.
EYEGW=Eyegate Pharmaceuticals, Inc.
HCSG=Healthcare Services Group, Inc.
EQBK=Equity Bancshares, Inc.
GAIN=Gladstone Investment Corporation
ROST=Ross Stores, Inc.
ELSE=Electr
ENZN=Enzon Pharmaceuticals, Inc.
FSV=FirstService Corporation
DAVE=Famous Dave's of America, Inc.
BHAC=Barington/Hilco Acquisition Corp.
QAT=iShares MSCI Qatar Capped ET
NURO=NeuroMetrix, Inc.
SBSA=Spanish Broadcasting System, Inc.
ACBI=Atlantic Capital Bancshares, Inc.
PSDV=pSivida Corp.
KZ=KongZhong Corporation
UBCP=United Bancorp, Inc.
VTWG=Vanguard Russell 2000 Growth ET
NWPX=Northwest Pipe Company
ISTR=Investar Holding Corporation
JXSB=Jacksonville Bancorp Inc.
PRSNW=Perseon Corporation
ULTA=Ulta Salon, Cosmetics & Fragrance, Inc.
ATRO=Astronics Corporation
CARA=Cara Therapeutics, Inc.
FLKS=Flex Pharma, Inc.
LFVN=Lifevantage Corporation
CAMP=CalAmp Corp.
ARIA=ARIAD Pharmaceuticals, Inc.
LOGM=LogMein, Inc.
DHXM=DHX Media Ltd.
APLP=Archrock Partners, L.P.
IEUS=iShares MSCI Europe Smal
CADTW=DT Asia Investments Limited
NWLI=National Western Life Group, Inc.
MOBI=Sk
BOKF=BOK Financial Corporation
MMSI=Merit Medical Systems, Inc.
HTWR=Heartware International, Inc.
ESSA=ESSA Bancorp, Inc.
SONS=Sonus Networks, Inc.
FEIM=Frequency Electronics, Inc.
SRCE=1st Source Corporation
WBMD=WebMD Health Corp
CPIX=Cumberland Pharmaceuticals Inc.
HTLF=Heartland Financial USA, Inc.
APOL=Apollo Education Group, Inc.
SODA=SodaStream International Ltd.
ATTU=Attunity Ltd.
UNAM=Unico American Corporation
VTVT=vTv Therapeutics Inc.
MAUI=AdvisorShares Market Adaptive Unconstrained Income ET
WSFSL=WSFS Financial Corporation
GOODP=Gladstone Commercial Corporation
TRIL=Trillium Therapeutics Inc.
GLDC=Golden Enterprises, Inc.
VIMC=Vimicro International Corporation
WB=Weibo Corporation
PRSS=CafePress Inc.
TCCO=Technical Communications Corporation
ETFC=E*TRADE Financial Corporation
CHSCO=CHS Inc
CRESY=Cresud S.A.C.I.F. y A.
ASYS=Amtech Systems, Inc.
PGNX=Progenics Pharmaceuticals Inc.
CZFC=Citizens First Corporation
SAIA=Saia, Inc.
EXAS=Exact Sciences Corporation
BDE=Black Diamond, Inc.
ESMC=Escalon Medical Corp.
MTRX=Matrix Service Company
CUR=Neuralstem, Inc.
XLRN=Acceleron Pharma Inc.
MFRM=Mattress Firm Holding Corp.
GSIG=GSI Group, Inc.
GOMO=Sungy Mobile Limited
CLFD=Clearfield, Inc.
LIFE=aTyr Pharma, Inc.
NVDA=NVIDIA Corporation
HCAC=Hennessy Capital Acquisition Corp. II
CHMG=Chemung Financial Corp
MBWM=Mercantile Bank Corporation
MDGS=Medigus Ltd.
ORBC=ORBCOMM Inc.
AMSF=AMERISAFE, Inc.
PKBK=Parke Bancorp, Inc.
TTS=Tile Shop Hldgs, Inc.
PINC=Premier, Inc.
NIHD=NII Holdings, Inc.
DSGX=The Descartes Systems Group Inc.
CATYW=Cathay General Bancorp
ATNY=API Technologies Corp.
EBAY=eBay Inc.
CART=Carolina Trust Bank
WWD=Woodward, Inc.
CHNR=China Natural Resources, Inc.
GRSH=Gores Holdings, Inc.
SMED=Sharps Compliance Corp
STPP=Barclays PLC
FINL=The Finish Line, Inc.
PCCC=PC Connection, Inc.
USCR=U S Concrete, Inc.
NTRA=Natera, Inc.
TLMR=Talmer Bancorp, Inc.
XENT=Intersect ENT, Inc.
TRIP=TripAdvisor, Inc.
DMRC=Digimarc Corporation
CVCY=Central Valley Community Bancorp
FSBW=FS Bancorp, Inc.
FLIR=FLIR Systems, Inc.
AUMA=AR Capital Acquisition Corp.
JMBA=Jamba, Inc.
CBYL=Carbylan Therapeutics, Inc.
DLHC=DLH Holdings Corp.
CIBR=First Trust NASDAQ CEA Cybersecurity ET
MRVL=Marvell Technology Group Ltd.
MIDD=The Middleby Corporation
DYNT=Dynatronics Corporation
DGICA=Donegal Group, Inc.
FLML=Flamel Technologies S.A.
NVDQ=Novadaq Technologies Inc
CHMA=Chiasma, Inc.
SSRI=Silver Standard Resources Inc.
URBN=Urban Outfitters, Inc.
BLCM=Bellicum Pharmaceuticals, Inc.
TCBIW=Texas Capital Bancshares, Inc.
MDXG=MiMedx Group, Inc
NVEE=NV5 Holdings, Inc.
STML=Stemline Therapeutics, Inc.
AEY=ADDvantage Technologies Group, Inc.
POOL=Pool Corporation
QTNT=Quotient Limited
EA=Electronic Arts Inc.
GPIA=GP Investments Acquisition Corp.
RDNT=RadNet, Inc.
CHCO=City Holding Company
MATW=Matthews International Corporation
RUTH=Ruth's Hospitality Group, Inc.
PNNT=PennantPark Investment Corporation
SGRY=Surgery Partners, Inc.
BCBP=BCB Bancorp, Inc. (NJ)
MGLN=Magellan Health, Inc.
CNV=Cnova N.V.
FORD=Forward Industries, Inc.
SAVE=Spirit Airlines, Inc.
ITRN=Ituran Location and Control Ltd.
GWGH=GWG Holdings, Inc
NEWTZ=Newtek Business Services Corp.
TXN=Texas Instruments Incorporated
GIFI=Gulf Island Fabrication, Inc.
SPIL=Siliconware Precision Industries Company, Ltd.
CSCO=Cisco Systems, Inc.
GPACW=Global Partner Acquisition Corp.
GPACU=Global Partner Acquisition Corp.
HRMNU=Harmony Merger Corp.
SBCP=Sunshine Bancorp, Inc.
CECO=Career Education Corporation
MIND=Mitcham Industries, Inc.
ETRM=EnteroMedics Inc.
RIGL=Rigel Pharmaceuticals, Inc.
CFBK=Central Federal Corporation
EFII=Electronics for Imaging, Inc.
INWK=InnerWorkings, Inc.
SOFO=Sonic Foundry, Inc.
MNDO=MIND C.T.I. Ltd.
ASRVP=AmeriServ Financial Inc.
SNTA=Synta Pharmaceuticals Corp.
TROW=T. Rowe Price Group, Inc.
CTIC=CTI BioPharma Corp.
VBIV=VBI Vaccines Inc.
CXSE=WisdomTree China e
CMFN=CM Finance Inc
PACB=Pacific Biosciences of California, Inc.
EVAR=Lombard Medical, Inc.
AQMS=Aqua Metals, Inc.
CXRX=Concordia Healthcare Corp.
SNMX=Senomyx, Inc.
TLGT=Teligent, Inc.
CLUB=Town Sports International Holdings, Inc.
AEGR=Aegerion Pharmaceuticals, Inc.
RCON=Recon Technology, Ltd.
NVIV=InVivo Therapeutics Holdings Corp.
HDRAU=Hydra Industries Acquisition Corp.
AGNC=American Capital Agency Corp.
NLNK=NewLink Genetics Corporation
SASR=Sandy Spring Bancorp, Inc.
TOUR=Tuniu Corporation
LCNB=LCNB Corporation
GNMK=GenMark Diagnostics, Inc.
ZION=Zions Bancorporation
ATOS=Atossa Genetics Inc.
TROVU=TrovaGene, Inc.
GPIC=Gaming Partners International Corporation
GSIT=GSI Technology, Inc.
VISN=VisionChina Media, Inc.
SYNL=Synalloy Corporation
CLLS=Cellectis S.A.
DXM=Dex Media, Inc.
SGRP=SPAR Group, Inc.
CAFD=8point3 Energy Partners LP
FSYS=Fuel Systems Solutions, Inc.
KHC=The Kraft Heinz Company
SINA=Sina Corporation
HMST=HomeStreet, Inc.
MCUR=Macrocure Ltd.
PFSW=PFSweb, Inc.
FSAM=Fifth Street Asset Management Inc.
RDI=Reading International Inc
NDLS=Noodles & Company
COBZ=CoBiz Financial Inc.
NEO=NeoGenomics, Inc.
ANAC=Anacor Pharmaceuticals, Inc.
EXXI=Energy XXI Ltd.
TORM=TOR Minerals International Inc
MHGC=Morgans Hotel Group Co.
DRAD=Digirad Corporation
HIHO=Highway Holdings Limited
WLRHU=WL Ross Holding Corp.
FPXI=First Trust International IPO ET
CASI=CASI Pharmaceuticals, Inc.
WAFD=Washington Federal, Inc.
MITK=Mitek Systems, Inc.
RLOC=ReachLocal, Inc.
CSWC=Capital Southwest Corporation
FOXF=Fox Factory Holding Corp.
ARCI=Appliance Recycling Centers of America, Inc.
ONCE=Spark Therapeutics, Inc.
SNC=State National Companies, Inc.
TMUSP=
SSRG=Symmetry Surgical Inc.
STLY=Stanley Furniture Company, Inc.
LOAN=Manhattan Bridge Capital, Inc
CERC=Cerecor Inc.
CAAS=China Automotive Systems, Inc.
ITEQ=BlueStar T
ROKA=Roka Bioscience, Inc.
SFLY=Shutterfly, Inc.
SONC=Sonic Corp.
USEG=U.S. Energy Corp.
LANC=Lancaster Colony Corporation
RGSE=Real Goods Solar, Inc.
HELE=Helen of Troy Limited
LECO=Lincoln Electric Holdings, Inc.
AMOT=Allied Motion Technologies, Inc.
KBIO=KaloBios Pharmaceuticals, Inc.
CUBN=Commerce Union Bancshares, Inc.
CCLP=CSI Compressco LP
PETS=PetMed Express, Inc.
TTGT=TechTarget, Inc.
CYAN=Cyanotech Corporation
LVNTA=Liberty Interactive Corporation
QLIK=Qlik Technologies Inc.
GBCI=Glacier Bancorp, Inc.
TREE=LendingTree, Inc.
CAPR=Capricor Therapeutics, Inc.
ULTI=The Ultimate Software Group, Inc.
URRE=Uranium Resources, Inc.
BLFS=BioLife Solutions, Inc.
FORK=Fuling Global Inc.
UFPT=UFP Technologies, Inc.
BGCP=BGC Partners, Inc.
RVSB=Riverview Bancorp Inc
IPWR=Ideal Power Inc.
HSTM=HealthStream, Inc.
ZSPH=ZS Pharma, Inc.
NTEC=Intec Pharma Ltd.
PARN=Parnell Pharmaceuticals Holdings Ltd
DHIL=Diamond Hill Investment Group, Inc.
USAP=Universal Stainless & Alloy Products, Inc.
EFUT=eFuture Information Technology Inc.
TRCB=Two River Bancorp
AEPI=AEP Industries Inc.
CNLMR=CB Pharma Acquisition Corp.
INTC=Intel Corporation
ERIC=Ericsson
SHOO=Steven Madden, Ltd.
KITE=Kite Pharma, Inc.
CFFI=C&F Financial Corporation
CRBP=Corbus Pharmaceuticals Holdings, Inc.
DXPE=DXP Enterprises, Inc.
ALNY=Alnylam Pharmaceuticals, Inc.
STBZ=State Bank Financial Corporation.
CTG=Computer Task Group, Incorporated
TECH=Bi
ONTY=Oncothyreon Inc.
RTTR=Ritter Pharmaceuticals, Inc.
ERI=Eldorado Resorts, Inc.
NSPH=Nanosphere, Inc.
SGNL=Signal Genetics, Inc.
NBBC=NewBridge Bancorp
OASM=Oasmia Pharmaceutical AB
NCMI=National CineMedia, Inc.
SATS=EchoStar Corporation
SLMBP=SLM Corporation
SIAL=Sigm
FCEL=FuelCell Energy, Inc.
NEON=Neonode Inc.
JOBS=51job, Inc.
LMIA=LMI Aerospace, Inc.
ASBI=Ameriana Bancorp
GAIA=Gaiam, Inc.
BYFC=Broadway Financial Corporation
GRSHU=Gores Holdings, Inc.
OHGI=One Horizon Group, Inc.
DXKW=WisdomTree Korea Hedged Equity Fun
CENT=Central Garden & Pet Company
CHRW=C.H. Robinson Worldwide, Inc.
CPLA=Capella Education Company
PHII=PHI, Inc.
LCUT=Lifetime Brands, Inc.
LILAK=Liberty Global plc
CKEC=Carmike Cinemas, Inc.
DRRX=DURECT Corporation
YOD=You On Demand Holdings, Inc.
HOLX=Hologic, Inc.
BZUN=Baozun Inc.
KTCC=Key Tronic Corporation
SAUC=Diversified Restaurant Holdings, Inc.
NDRM=NeuroDerm Ltd.
CIGI=Colliers International Group Inc.
GABC=German American Bancorp, Inc.
VYGR=Voyager Therapeutics, Inc.
CDORP=Condor Hospitality Trust, Inc.
IRDM=Iridium Communications Inc
GIGM=GigaMedia Limited
CWST=Casella Waste Systems, Inc.
CALI=China Auto Logistics Inc.
ZIXI=Zix Corporation
XNET=Xunlei Limited
BRKS=Brooks Automation, Inc.
VBFC=Village Bank and Trust Financial Corp.
ARDX=Ardelyx, Inc.
KONE=Kingtone Wirelessinfo Solution Holding Ltd
UMPQ=Umpqua Holdings Corporation
ICCC=ImmuCell Corporation
KANG=iKang Healthcare Group, Inc.
CLCD=CoLucid Pharmaceuticals, Inc.
WDFC=W
HSII=Heidrick & Struggles International, Inc.
ICFI=ICF International, Inc.
OSBCP=Old Second Bancorp, Inc.
HCOM=Hawaiian Telcom Holdco, Inc.
VGLT=Vanguard Lon
SYPR=Sypris Solutions, Inc.
RTIX=RTI Surgical, Inc.
REPH=Recro Pharma, Inc.
TLF=Tandy Leather Factory, Inc.
SQI=SciQuest, Inc.
ITRI=Itron, Inc.
SKLN=Skyline Medical Inc.
VOXX=VOXX International Corporation
IMKTA=Ingles Markets, Incorporated
BIOS=BioScrip, Inc.
SSB=South State Corporation
GLPI=Gaming and Leisure Properties, Inc.
SIGM=Sigma Designs, Inc.
CLACU=Capitol Acquisition Corp. III
SYBT=Stock Yards Bancorp, Inc.
CNTY=Century Casinos, Inc.
GOOGL=Alphabet Inc.
TNDM=Tandem Diabetes Care, Inc.
FCVA=First Capital Bancorp, Inc. (VA)
FEP=First Trust Europe AlphaDEX Fun
LIVN=LivaNova PLC
GALTW=Galectin Therapeutics Inc.
NUROW=NeuroMetrix, Inc.
OHRP=Ohr Pharmaceuticals, Inc.
OCLS=Oculus Innovative Sciences, Inc.
MGPI=MGP Ingredients, Inc.
AMAT=Applied Materials, Inc.
KOSS=Koss Corporation
RBCAA=Republic Bancorp, Inc.
NWFL=Norwood Financial Corp.
WERN=Werner Enterprises, Inc.
DSWL=Deswell Industries, Inc.
SSBI=Summit State Bank
KMPH=KemPharm, Inc.
LYTS=LSI Industries Inc.
WSTG=Wayside Technology Group, Inc.
CBF=Capital Bank Financial Corp.
GBDC=Golub Capital BDC, Inc.
SOHO=Sotherly Hotels Inc.
MDLZ=Mondelez International, Inc.
WPRT=Westport Innovations Inc
RNST=Renasant Corporation
PSCH=PowerShares S&P SmallCap Health Care Portfoli
CERCW=Cerecor Inc.
VRTB=Vestin Realty Mortgage II, Inc.
NDAQ=Nasdaq, Inc.
BANFP=BancFirst Corporation
EXPD=Expeditors International of Washington, Inc.
EAC=Erickson Incorporated
SILC=Silicom Ltd
USAT=USA Technologies, Inc.
GOGL=Golden Ocean Group Limited
BOBE=Bob Evans Farms, Inc.
DSKY=iDreamSky Technology Limited
CTRP=Ctrip.com International, Ltd.
CFRX=ContraFect Corporation
CONE=CyrusOne Inc
HBAN=Huntington Bancshares Incorporated
CDW=CDW Corporation
FALC=FalconStor Software, Inc.
FANG=Diamondback Energy, Inc.
IPAS=iPass Inc.
MLNK=ModusLink Global Solutions, Inc
BITE=The Restaurant ET
KOPN=Kopin Corporation
IBKCP=IBERIABANK Corporation
ELRC=Electro Rent Corporation
FV=First Trust Dorsey Wright Focus 5 ET
ELECW=Electrum Special Acquisition Corporation
DSCI=Derma Sciences, Inc.
TLOG=TetraLogic Pharmaceuticals Corporation
INDY=iShares S&P India Nifty 50 Index Fun
UPIP=Unwired Planet, Inc.
DWSN=Dawson Geophysical Company
SPWR=SunPower Corporation
FXCB=Fox Chase Bancorp, Inc.
RRD=R.R. Donnelley & Sons Company
DTEA=DAVIDsTEA Inc.
IRBT=iRobot Corporation
INAP=Internap Corporation
FRME=First Merchants Corporation
WILN=W
NSIT=Insight Enterprises, Inc.
FRP=FairPoint Communications, Inc.
MCOX=Mecox Lane Limited
LDRI=PowerShares LadderRite
FFBCW=First Financial Bancorp.
LEDS=SemiLEDS Corporation
LAND=Gladstone Land Corporation
OVBC=Ohio Valley Banc Corp.
ATVI=Activision Blizzard, Inc
XTLB=XTL Biopharmaceuticals Ltd.
WSTL=Westell Technologies, Inc.
MRKT=Markit Ltd.
CPSH=CPS Technologies Corp.
ITEK=Inotek Pharmaceuticals Corporation
MDSY=ModSys International Ltd.
HOVNP=Hovnanian Enterprises Inc
ADAT=Authentidate Holding Corp.
PVTB=PrivateBancorp, Inc.
APWC=Asia Pacific Wire & Cable Corporation Limited
TTPH=Tetraphase Pharmaceuticals, Inc.
ORPN=Bio Blast Pharma Ltd.
WAYN=Wayne Savings Bancshares Inc.
VIVO=Meridian Bioscience Inc.
EZPW=EZCORP, Inc.
TCX=Tucows Inc.
AETI=American Electric Technologies, Inc.
FIVE=Five Below, Inc.
CJJD=China J
MYRG=MYR Group, Inc.
SGYPW=Synergy Pharmaceuticals, Inc.
GLYC=GlycoMimetics, Inc.
FTHI=First Trust High Income ET
SVBI=Severn Bancorp Inc
MAYS=J. W. Mays, Inc.
PFLT=PennantPark Floating Rate Capital Ltd.
MTLS=Materialise NV
LKFN=Lakeland Financial Corporation
SXCL=Steel Excel Inc.
UCBA=United Community Bancorp
CNFR=Conifer Holdings, Inc.
ANSS=ANSYS, Inc.
FNJN=Finjan Holdings, Inc.
SPNC=The Spectranetics Corporation
IPAR=Inter Parfums, Inc.
UBNT=Ubiquiti Networks, Inc.
TFSL=TFS Financial Corporation
ZGNX=Zogenix, Inc.
WAFDW=Washington Federal, Inc.
CAMT=Camtek Ltd.
CBRL=Cracker Barrel Old Country Store, Inc.
NYMT=New York Mortgage Trust, Inc.
CEMI=Chembio Diagnostics, Inc.
CRZO=Carrizo Oil & Gas, Inc.
SCLN=SciClone Pharmaceuticals, Inc.
ABCB=Ameris Bancorp
CAR=Avis Budget Group, Inc.
CIDM=Cinedigm Corp
NVAX=Novavax, Inc.
XBKS=Xenith Bankshares, Inc.
SYNA=Synaptics Incorporated
SZMK=Sizmek Inc.
ZUMZ=Zumiez Inc.
NWBI=Northwest Bancshares, Inc.
IIIN=Insteel Industries, Inc.
BLDP=Ballard Power Systems, Inc.
IART=Integra LifeSciences Holdings Corporation
QRHC=Quest Resource Holding Corporation.
CHFC=Chemical Financial Corporation
AKBA=Akebia Therapeutics, Inc.
USATP=USA Technologies, Inc.
TTMI=TTM Technologies, Inc.
ISLE=Isle of Capri Casinos, Inc.
HLG=Hailiang Education Group Inc.
GLBZ=Glen Burnie Bancorp
ISNS=Image Sensing Systems, Inc.
GGACU=Garnero Group Acquisition Company
CTBI=Community Trust Bancorp, Inc.
HMPR=Hampton Roads Bankshares Inc
SPAR=Spartan Motors, Inc.
VNR=Vanguard Natural Resources LLC
PLNR=Planar Systems, Inc.
ABEO=Abeona Therapeutics Inc.
CFRXW=ContraFect Corporation
TSC=TriState Capital Holdings, Inc.
CCRN=Cross Country Healthcare, Inc.
JVA=Coffee Holding Co., Inc.
CINF=Cincinnati Financial Corporation
COB=CommunityOne Bancorp
PCBK=Pacific Continental Corporation (Ore)
GSVC=GSV Capital Corp
CAPN=Capnia, Inc.
NERV=Minerva Neurosciences, Inc
AKER=Akers Biosciences Inc
CEMP=Cempra, Inc.
XCOM=Xtera Communications, Inc.
OXLCO=Oxford Lane Capital Corp.
LUNA=Luna Innovations Incorporated
SMSI=Smith Micro Software, Inc.
LINC=Lincoln Educational Services Corporation
ERII=Energy Recovery, Inc.
MTEX=Mannatech, Incorporated
SOCB=Southcoast Financial Corporation
TUTT=Tuttle Tactical Management U.S. Core ET
IVAC=Intevac, Inc.
WVVI=Willamette Valley Vineyards, Inc.
ESES=Ec
DRAM=Dataram Corporation
STAF=Staffing 360 Solutions, Inc.
PMBC=Pacific Mercantile Bancorp
ADMA=ADMA Biologics Inc
OTTR=Otter Tail Corporation
DMTX=Dimension Therapeutics, Inc.
OLBK=Old Line Bancshares, Inc.
OUTR=Outerwall Inc.
CYNA=Cynapsus Therapeutics Inc.
ESSX=Essex Rental Corporation
PODD=Insulet Corporation
SYUT=Synutra International, Inc.
SNBC=Sun Bancorp, Inc.
DVAX=Dynavax Technologies Corporation
VIRT=Virtu Financial, Inc.
FONE=First Trust NASDAQ CEA Smartphone Index Fun
DCIX=Diana Containerships Inc.
ACPW=Active Power, Inc.
MSBF=MSB Financial Corp.
ALTY=Global X SuperDividend Alternatives ET
KCLI=Kansas City Life Insurance Company
BPOPM=Popular, Inc.
HEES=H&E Equipment Services, Inc.
NHLD=National Holdings Corporation
RMTI=Rockwell Medical, Inc.
WLFC=Willis Lease Finance Corporation
NKTR=Nektar Therapeutics
UTEK=Ultratech, Inc.
CAMBU=Cambridge Capital Acquisition Corporation
BLRX=BioLineRx Ltd.
SHLM=A. Schulman, Inc.
GT=The Goodyear Tire & Rubber Company
ZJZZT=NASDAQ TEST STOC
OXFD=Oxford Immunotec Global PLC
CNTF=China TechFaith Wireless Communication Technology Limited
MARPS=Marine Petroleum Trust
DGII=Digi International Inc.
TRMB=Trimble Navigation Limited
KFFB=Kentucky First Federal Bancorp
QPACW=Quinpario Acquisition Corp. 2
TWER=Towerstream Corporation
MSCC=Microsemi Corporation
LULU=lululemon athletica inc.
DERM=Dermira, Inc.
HNNA=Hennessy Advisors, Inc.
AZPN=Aspen Technology, Inc.
PRZM=Prism Technologies Group, Inc.
GRBK=Green Brick Partners, Inc.
SUBK=Suffolk Bancorp
BKMU=Bank Mutual Corporation
IOSP=Innospec Inc.
NTRSP=Northern Trust Corporation
CZWI=Citizens Community Bancorp, Inc.
NWSA=News Corporation
IGLD=Internet Gold Golden Lines Ltd.
APPF=AppFolio, Inc.
UK=Recon Capital FTSE 100 ET
MDCO=The Medicines Company
CHRS=Coherus BioSciences, Inc.
ANAT=American National Insurance Company
ABDC=Alcentra Capital Corp.
CALM=Ca
NICK=Nicholas Financial, Inc.
HOTRW=Chanticleer Holdings, Inc.
FMBH=First Mi
CUBA=The Herzfeld Caribbean Basin Fund, Inc.
MEMP=Memorial Production Partners LP
LOCO=El Pollo Loco Holdings, Inc.
AROW=Arrow Financial Corporation
VLTC=Voltari Corporation
VIIX=Credit Suisse AG
NTRI=NutriSystem Inc
THFF=First Financial Corporation Indiana
CG=The Carlyle Group L.P.
KGJI=Kingold Jewelry Inc.
SMCI=Super Micro Computer, Inc.
HYGS=Hydrogenics Corporation
UNTY=Unity Bancorp, Inc.
BOJA=Bojangles', Inc.
IBTX=Independent Bank Group, Inc
CYCCP=Cyclacel Pharmaceuticals, Inc.
NAUH=National American University Holdings, Inc.
SP=SP Plus Corporation
AFSI=AmTrust Financial Services, Inc.
MOBL=MobileIron, Inc.
FJP=First Trust Japan AlphaDEX Fun
TCON=TRACON Pharmaceuticals, Inc.
EXAC=Exactech, Inc.
ARRS=ARRIS Group, Inc.
GWPH=GW Pharmaceuticals Plc
BBOX=Black Box Corporation
HOTR=Chanticleer Holdings, Inc.
SMMF=Summit Financial Group, Inc.
SMCP=AlphaMark Actively Managed Small Cap ET
FARM=Farmer Brothers Company
PYDS=Payment Data Systems, Inc.
FCAP=First Capital, Inc.
KTWO=K2M Group Holdings, Inc.
GLADO=Gladstone Capital Corporation
ANY=Sphere 3D Corp.
RIVR=River Valley Bancorp.
SYMC=Symantec Corporation
MTBC=Medical Transcription Billing, Corp.
AGZD=WisdomTree Barclays U.S. Aggregate Bond Zero Duration Fun
COYNW=COPsync, Inc.
PULM=Pulmatrix, Inc.
PRKR=ParkerVision, Inc.
EACQ=Easterly Acquisition Corp.
OMEX=Odyssey Marine Exploration, Inc.
DTYL=Barclays PLC
RLOG=Rand Logistics, Inc.
THRM=Gentherm Inc
PRSN=Perseon Corporation
DWA=Dreamworks Animation SKG, Inc.
ATHX=Athersys, Inc.
FCAN=First Trust Canada AlphaDEX Fun
WHFBL=WhiteHorse Finance, Inc.
REGI=Renewable Energy Group, Inc.
UNB=Union Bankshares, Inc.
NTK=Nortek Inc.
PROV=Provident Financial Holdings, Inc.
FLWS=
ATRC=AtriCure, Inc.
NPBC=National Penn Bancshares, Inc.
MACK=Merrimack Pharmaceuticals, Inc.
OTEX=Open Text Corporation
SGYPU=Synergy Pharmaceuticals, Inc.
BLVDU=Boulevard Acquisition Corp. II
CSCD=Cascade Microtech, Inc.
ZHNE=Zhone Technologies, Inc.
CATB=Catabasis Pharmaceuticals, Inc.
WEN=Wendy's Company (The)
EXPO=Exponent, Inc.
QYLD=Recon Capital NASDA
GNVC=GenVec, Inc.
HTHT=China Lodging Group, Limited
SPNS=Sapiens International Corporation N.V.
VGGL=Viggle Inc.
SBOT=Stellar Biotechnologies, Inc.
XCRA=Xcerra Corporation
VSCP=VirtualScopics, Inc.
OSBC=Old Second Bancorp, Inc.
MFRI=MFRI, Inc.
TRST=TrustCo Bank Corp NY
GBT=Global Blood Therapeutics, Inc.
TACO=Del Taco Restaurants, Inc.
EEFT=Euronet Worldwide, Inc.
PEIX=Pacific Ethanol, Inc.
PSCU=PowerShares S&P SmallCap Utilities Portfoli
DORM=Dorman Products, Inc.
HOLI=Hollysys Automation Technologies, Ltd.
MYOS=MYOS Corporation
AXTI=AXT Inc
BCOR=Blucora, Inc.
ONB=Old National Bancorp
MBUU=Malibu Boats, Inc.
LPSN=LivePerson, Inc.
FFNM=First Federal of Northern Michigan Bancorp, Inc.
BWEN=Broadwind Energy, Inc.
MBFIP=MB Financial Inc.
SGYP=Synergy Pharmaceuticals, Inc.
FNSR=Finisar Corporation
TCPC=TCP Capital Corp.
AVNW=Aviat Networks, Inc.
MGNX=MacroGenics, Inc.
SALE=RetailMeNot, Inc.
CTAS=Cintas Corporation
JNP=Juniper Pharmaceuticals, Inc.
UBNK=United Financial Bancorp, Inc.
VNQI=Vanguard Global e
MAMS=MAM Software Group, Inc.
AKAM=Akamai Technologies, Inc.
SHBI=Shore Bancshares Inc
AMRS=Amyris, Inc.
LSTR=Landstar System, Inc.
SCAI=Surgical Care Affiliates, Inc.
GSBC=Great Southern Bancorp, Inc.
MRLN=Marlin Business Services Corp.
TFSCW=1347 Capital Corp.
CU=First Trust ISE Global Copper Index Fun
LINE=Linn Energy, LLC
TDIV=First Trust NASDAQ Technology Dividend Index Fun
EGLT=Egalet Corporation
ARWAU=Arowana Inc.
RAVE=Rave Restaurant Group, Inc.
OSM=SLM Corporation
CY=Cypress Semiconductor Corporation
ALGT=Allegiant Travel Company
ADRO=Aduro Biotech, Inc.
ALRM=Alarm.com Holdings, Inc.
AOSL=Alpha and Omega Semiconductor Limited
BMTC=Bryn Mawr Bank Corporation
STLD=Steel Dynamics, Inc.
RTK=Rentech, Inc.
FFNW=First Financial Northwest, Inc.
NFLX=Netflix, Inc.
SMTP=SMTP, Inc.
FTR=Frontier Communications Corporation
WRES=Warren Resources, Inc.
NEWP=Newport Corporation
PNFP=Pinnacle Financial Partners, Inc.
EGRX=Eagle Pharmaceuticals, Inc.
VONG=Vanguard Russell 1000 Growth ET
TTOO=T2 Biosystems, Inc.
CDTI=Clean Diesel Technologies, Inc.
WASH=Washington Trust Bancorp, Inc.
OREX=Orexigen Therapeutics, Inc.
OCUL=Ocular Therapeutix, Inc.
AUBN=Auburn National Bancorporation, Inc.
CCBG=Capital City Bank Group
CARB=Carbonite, Inc.
CRAI=CRA International,Inc.
BV=Bazaarvoice, Inc.
LAKE=Lakeland Industries, Inc.
UTIW=UTi Worldwide Inc.
ARQL=ArQule, Inc.
ADMS=Adamas Pharmaceuticals, Inc.
FRBA=First Bank
AGIIL=Argo Group International Holdings, Ltd.
SITO=SITO Mobile, Ltd.
GRVY=GRAVITY Co., Ltd.
HCACW=Hennessy Capital Acquisition Corp. II
SIXD=6D Global Technologies, Inc.
MOKO=MOKO Social Media Ltd.
CCD=Calamos Dynamic Convertible & Income Fund
MEIL=Methes Energies International Ltd
TSCO=Tractor Supply Company
XGTI=XG Technology, Inc
MMAC=MMA Capital Management, LLC
MFSF=MutualFirst Financial Inc.
TUBE=TubeMogul, Inc.
HMIN=Homeinns Hotel Group
EPIX=ESSA Pharma Inc.
NBTB=NBT Bancorp Inc.
FAST=Fastenal Company
TNXP=Tonix Pharmaceuticals Holding Corp.
FFBC=First Financial Bancorp.
ROSG=Rosetta Genomics Ltd.
GAI=Globa
ACAT=Arctic Cat Inc.
OSIS=OSI Systems, Inc.
ONCS=OncoSec Medical Incorporated
JST=Jinpan International Limited
VTAE=Vitae Pharmaceuticals, Inc.
OSIR=Osiris Therapeutics, Inc.
ACTX=Global X Guru Activist ET
MNST=Monster Beverage Corporation
CGNT=Cogentix Medical, Inc.
OMED=OncoMed Pharmaceuticals, Inc.
AREX=Approach Resources Inc.
VUZI=Vuzix Corporation
AEMD=Aethlon Medical, Inc.
AMAG=AMAG Pharmaceuticals, Inc.
BLKB=Blackbaud, Inc.
CLWT=Euro Tech Holdings Company Limited
PFBC=Preferred Bank
LTRPA=Liberty TripAdvisor Holdings, Inc.
CBIO=Catalyst Biosciences, Inc.
OFED=Oconee Federal Financial Corp.
CASM=CAS Medical Systems, Inc.
PLCE=Children's Place, Inc. (The)
SFNC=Simmons First National Corporation
ANDE=The Andersons, Inc.
NANO=Nanometrics Incorporated
KLIC=Kulicke and Soffa Industries, Inc.
LTRPB=Liberty TripAdvisor Holdings, Inc.
CETC=Hongli Clean Energy Technologies Corp.
DWAT=Arrow DWA Tactical ET
SSH=Sunshine Heart Inc
AMKR=Amkor Technology, Inc.
BBP=BioShares Biotechnology Products Fun
AEHR=Aehr Test Systems
CVBF=CVB Financial Corporation
PCOM=Points International, Ltd.
TTNP=Titan Pharmaceuticals, Inc.
CDK=CDK Global, Inc.
CHUY=Chuy's Holdings, Inc.
CRDS=Crossroads Systems, Inc.
KWEB=KraneShares CSI China Internet ET
IILG=Interval Leisure Group, Inc.
SAAS=inContact, Inc.
BPOP=Popular, Inc.
POZN=Pozen, Inc.
AMBA=Ambarella, Inc.
TROV=TrovaGene, Inc.
UMBF=UMB Financial Corporation
FENX=Fenix Parts, Inc.
TBIO=Transgenomic, Inc.
IDLB=PowerShares FTSE International Low Beta Equal Weight Portfoli
AAVL=Avalanche Biotechnologies, Inc.
LORL=Loral Space and Communications, Inc.
OCFC=OceanFirst Financial Corp.
CZR=Caesars Entertainment Corporation
RCKY=Rocky Brands, Inc.
MGEE=MGE Energy Inc.
WIBC=Wilshire Bancorp, Inc.
DARA=DARA Biosciences, Inc.
YDLE=Yodlee, Inc.
CNIT=China Information Technology, Inc.
SBSI=Southside Bancshares, Inc.
CVGW=Calavo Growers, Inc.
JD=JD.com, Inc.
FIZZ=National Beverage Corp.
ILMN=Illumina, Inc.
VGSH=Vanguard Shor
PSCT=PowerShares S&P SmallCap Information Technology Portfoli
HRZN=Horizon Technology Finance Corporation
AGYS=Agilysys, Inc.
UFPI=Universal Forest Products, Inc.
RAND=Rand Capital Corporation
SLGN=Silgan Holdings Inc.
AMRI=Albany Molecular Research, Inc.
HDRAR=Hydra Industries Acquisition Corp.
PEBO=Peoples Bancorp Inc.
TECD=Tech Data Corporation
WLB=Westmoreland Coal Company
CELGZ=Celgene Corporation
MERC=Mercer International Inc.
ALQA=Alliqua BioMedical, Inc.
BPTH=Bi
GURE=Gulf Resources, Inc.
DNAI=ProNAi Therapeutics, Inc.
IMOS=ChipMOS TECHNOLOGIES (Bermuda) LTD.
FPRX=Five Prime Therapeutics, Inc.
MARA=Marathon Patent Group, Inc.
VCSH=Vanguard Shor
LBTYB=Liberty Global plc
LHCG=LHC Group
UNTD=United Online, Inc.
JASO=JA Solar Holdings, Co., Ltd.
GAINO=Gladstone Investment Corporation
TRMK=Trustmark Corporation
DTUL=Barclays PLC
OPOF=Old Point Financial Corporation
SPNE=SeaSpine Holdings Corporation
DLTR=Dollar Tree, Inc.
OPXAW=Opexa Therapeutics, Inc.
FRBK=Republic First Bancorp, Inc.
RNET=RigNet, Inc.
BNFT=Benefitfocus, Inc.
LFUS=Littelfuse, Inc.
BDBD=Boulder Brands, Inc.
NAVG=The Navigators Group, Inc.
HTBI=HomeTrust Bancshares, Inc.
FLL=Full House Resorts, Inc.
CYRX=CryoPort, Inc.
HCAPL=Harvest Capital Credit Corporation
HBANP=Huntington Bancshares Incorporated
CHSCL=CHS Inc
CMTL=Comtech Telecommunications Corp.
LION=Fidelity Southern Corporation
SKOR=FlexShares Credi
STRM=Streamline Health Solutions, Inc.
VIRC=Virco Manufacturing Corporation
ICAD=icad inc.
NVGN=Novogen Limited
UTMD=Utah Medical Products, Inc.
LBAI=Lakeland Bancorp, Inc.
NYNY=Empire Resorts, Inc.
FMNB=Farmers National Banc Corp.
RDUS=Radius Health, Inc.
BBCN=BBCN Bancorp, Inc.
IPCI=Intellipharmaceutics International Inc.
REFR=Research Frontiers Incorporated
AUPH=Aurinia Pharmaceuticals Inc
ZVZZT=NASDAQ TEST STOC
LOJN=LoJack Corporation
VA=Virgin America Inc.
BWFG=Bankwell Financial Group, Inc.
ATML=Atmel Corporation
TWOU=2U, Inc.
CPHC=Canterbury Park Holding Corporation
CSB=Victory CEMP US Small Cap High Div Volatility Wtd Index ET
ERIE=Erie Indemnity Company
AMOV=America Movil, S.A.B. de C.V.
RFIL=RF Industries, Ltd.
NCTY=The9 Limited
MEIP=MEI Pharma, Inc.
CYBE=CyberOptics Corporation
BLVD=Boulevard Acquisition Corp. II
RELV=Reliv' International, Inc.
QLGC=QLogic Corporation
VSAT=ViaSat, Inc.
NICE=NIC
HUBG=Hub Group, Inc.
CERN=Cerner Corporation
PSCD=PowerShares S&P SmallCap Consumer Discretionary Portfoli
BRCM=Broadcom Corporation
CZNC=Citizens & Northern Corp
ANIK=Anika Therapeutics Inc.
HMNF=HMN Financial, Inc.
BNDX=Vanguard Total International Bond ET
RTRX=Retrophin, Inc.
ASFI=Asta Funding, Inc.
RRM=RR Media Ltd.
SNDK=SanDisk Corporation
PBCP=Polonia Bancorp, Inc.
NGHC=National General Holdings Corp
CWAY=Coastway Bancorp, Inc.
ININ=Interactive Intelligence Group, Inc.
MCBC=Macatawa Bank Corporation
FDML=Federa
ESLT=Elbit Systems Ltd.
VNOM=Viper Energy Partners LP
PNTR=Pointer Telocation Ltd.
ACAD=ACADIA Pharmaceuticals Inc.
STKS=The ONE Group Hospitality, Inc.
PRTO=Proteon Therapeutics, Inc.
CARV=Carver Bancorp, Inc.
VSTM=Verastem, Inc.
TW=Towers Watson & Co.
GTLS=Chart Industries, Inc.
UVSP=Univest Corporation of Pennsylvania
CAMBW=Cambridge Capital Acquisition Corporation
SPDC=Speed Commerce, Inc.
NUTR=Nutraceutical International Corporation
CBSHP=Commerce Bancshares, Inc.
CISG=CNinsure Inc.
VSAR=Versartis, Inc.
BNTC=Benitec Biopharma Limited
OPTT=Ocean Power Technologies, Inc.
WETF=WisdomTree Investments, Inc.
CTCM=CTC Media, Inc.
ADTN=ADTRAN, Inc.
DHRM=Dehaier Medical Systems Limited
FKU=First Trust United Kingdom AlphaDEX Fun
SMRT=Stein Mart, Inc.
DXLG=Destination XL Group, Inc.
PSEC=Prospect Capital Corporation
DFVS=Barclays PLC
SLTD=Solar3D, Inc.
TRIV=TriVascular Technologies, Inc.
MGRC=McGrath RentCorp
AMRN=Amarin Corporation plc
TSRI=TSR, Inc.
INGN=Inogen, Inc
PSBH=PSB Holdings, Inc.
DISCA=Discovery Communications, Inc.
WPPGY=WPP plc
EGAN=eGain Corporation
BBRY=BlackBerry Limited
CID=Victory CEMP International High Div Volatility Wtd Index ET
OZRK=Bank of the Ozarks
EVOK=Evoke Pharma, Inc.
AFH=Atlas Financial Holdings, Inc.
BONA=Bona Film Group Limited
ACLS=Axcelis Technologies, Inc.
INOV=Inovalon Holdings, Inc.
NVCR=NovoCure Limited
AAAP=Advanced Accelerator Applications S.A.
CLRBW=Cellectar Biosciences, Inc.
CHY=Calamos Convertible and High Income Fund
CHEK=Chec
RITTW=RIT Technologies Ltd.
WPCS=WPCS International Incorporated
CTCT=Constant Contact, Inc.
CETX=Cemtrex Inc.
PENN=Penn National Gaming, Inc.
CYHHZ=Community Health Systems, Inc.
JRVR=James River Group Holdings, Ltd.
FLDM=Fluidigm Corporation
ANCX=Access National Corporation
AMWD=American Woodmark Corporation
RSYS=RadiSys Corporation
NMRX=Numerex Corp.
CIVB=Civista Bancshares, Inc.
PBCT=People's United Financial, Inc.
EUFN=iShares MSCI Europe Financials Sector Index Fun
EML=Eastern Company (The)
BOCH=Bank of Commerce Holdings (CA)
HSKA=Heska Corporation
CORI=Corium International, Inc.
CDNS=Cadence Design Systems, Inc.
FSFR=Fifth Street Senior Floating Rate Corp.
JASNW=Jason Industries, Inc.
SBCF=Seacoast Banking Corporation of Florida
WIRE=Encore Wire Corporation
TFSCR=1347 Capital Corp.
MGYR=Magyar Bancorp, Inc.
CLDX=Celldex Therapeutics, Inc.
CBAN=Colony Bankcorp, Inc.
HYZD=WisdomTree BofA Merrill Lynch High Yield Bond Zero Duration Fun
FEMS=First Trust Emerging Markets Small Cap AlphaDEX Fun
IOTS=Adesto Technologies Corporation
CSQ=Calamos Strategic Total Return Fund
KRNT=Kornit Digital Ltd.
QCLN=First Trust NASDAQ Clean Edge Green Energy Index Fun
ZBRA=Zebra Technologies Corporation
MBVT=Merchants Bancshares, Inc.
OXBR=Oxbridge Re Holdings Limited
EQFN=Equitable Financial Corp.
GGACR=Garnero Group Acquisition Company
MTSL=MER Telemanagement Solutions Ltd.
ECYT=Endocyte, Inc.
HABT=The Habit Restaurants, Inc.
NWBOW=Northwest Biotherapeutics, Inc.
BNCL=Beneficial Bancorp, Inc.
GK=G&K Services, Inc.
QTWW=Quantum Fuel Systems Technologies Worldwide, Inc.
MNGA=MagneGas Corporation
NETE=Net Element, Inc.
CIZN=Citizens Holding Company
SAL=Salisbury Bancorp, Inc.
PULB=Pulaski Financial Corp.
LNCE=Snyder'
GULF=WisdomTree Middle East Dividend Fun
SCSS=Select Comfort Corporation
VCEL=Vericel Corporation
SBNYW=Signature Bank
HNRG=Hallador Energy Company
SUNS=Solar Senior Capital Ltd.
OSUR=OraSure Technologies, Inc.
MANH=Manhattan Associates, Inc.
ADMP=Adamis Pharmaceuticals Corporation
PMTS=CPI Card Group Inc.
PFIN=P & F Industries, Inc.
OXLCN=Oxford Lane Capital Corp.
BSET=Bassett Furniture Industries, Incorporated
PSCC=PowerShares S&P SmallCap Consumer Staples Portfoli
HERO=Hercules Offshore, Inc.
RGCO=RGC Resources Inc.
SQQQ=ProShares UltraPro Short QQ
VCYT=Veracyte, Inc.
STB=Student Transportation Inc
HQCL=Hanwha Q CELLS Co., Ltd.
KELYA=Kelly Services, Inc.
FNTC=FinTech Acquisition Corp.
EYES=Second Sight Medical Products, Inc.
TTEK=Tetra Tech, Inc.
ACOR=Acorda Therapeutics, Inc.
ARMH=ARM Holdings plc
ECOL=US Ecology, Inc.
ENPH=Enphase Energy, Inc.
GGAC=Garnero Group Acquisition Company
FNTCW=FinTech Acquisition Corp.
FBRC=FBR & Co
MGI=Moneygram International, Inc.
AGFSW=AgroFresh Solutions, Inc.
WSCI=WSI Industries Inc.
EPZM=Epizyme, Inc.
FUEL=Rocket Fuel Inc.
RYAAY=Ryanair Holdings plc
CMLS=Cumulus Media Inc.
CDZI=Cadiz, Inc.
AINV=Apollo Investment Corporation
XPLR=Xplore Technologies Corp
HWKN=Hawkins, Inc.
RMCF=Rocky Mountain Chocolate Factory, Inc.
FUND=Sprott Focus Trust, Inc.
ARCC=Ares Capital Corporation
TSEM=Tower Semiconductor Ltd.
ESND=Essendant Inc.
Z=Zillow Group, Inc.
UTES=Reaves Utilities ET
GLDI=Credit Suisse AG
BIOD=Biodel Inc.
NATL=National Interstate Corporation
ECHO=Echo Global Logistics, Inc.
AUMAU=AR Capital Acquisition Corp.
CMCT=CIM Commercial Trust Corporation
CREE=Cree, Inc.
INVE=Identiv, Inc.
AEIS=Advanced Energy Industries, Inc.
SWKS=Skyworks Solutions, Inc.
CNBKA=Century Bancorp, Inc.
LNTH=Lantheus Holdings, Inc.
BPFH=Boston Private Financial Holdings, Inc.
WTFCW=Wintrust Financial Corporation
MNTA=Momenta Pharmaceuticals, Inc.
IPGP=IPG Photonics Corporation
BONT=The Bo
USAK=USA Truck, Inc.
SFBC=Sound Financial Bancorp, Inc.
CGIX=Cancer Genetics, Inc.
ECTE=Echo Therapeutics, Inc.
ASNA=Ascena Retail Group, Inc.
RUSHB=Rush Enterprises, Inc.
GAINP=Gladstone Investment Corporation
LAWS=Lawson Products, Inc.
BFIN=BankFinancial Corporation
WVVIP=Willamette Valley Vineyards, Inc.
WIFI=Boingo Wireless, Inc.
UGLD=Credit Suisse AG
STKL=SunOpta, Inc.
LBTYK=Liberty Global plc
VNRAP=Vanguard Natural Resources LLC
EHTH=eHealth, Inc.
VRSK=Verisk Analytics, Inc.
RAVN=Raven Industries, Inc.
SCMP=Sucampo Pharmaceuticals, Inc.
CLVS=Clovis Oncology, Inc.
CAPNW=Capnia, Inc.
BUFF=Blue Buffalo Pet Products, Inc.
TAYD=Taylor Devices, Inc.
RMBS=Rambus, Inc.
LTXB=LegacyTexas Financial Group, Inc.
BSFT=BroadSoft, Inc.
AIQ=Alliance HealthCare Services, Inc.
MCFT=MCBC Holdings, Inc.
SRDX=SurModics, Inc.
POWL=Powell Industries, Inc.
PNQI=PowerShares Nasdaq Internet Portfoli
MMYT=MakeMyTrip Limited
CERU=Cerulean Pharma Inc.
LAYN=Layne Christensen Company
BBEPP=Breitburn Energy Partners LP
JCS=Communications Systems, Inc.
ZLTQ=ZELTIQ Aesthetics, Inc.
AIMT=Aimmune Therapeutics, Inc.
MDIV=Mult
BIB=ProShares Ultra Nasdaq Biotechnolog
DTRM=Determine, Inc.
UBIO=Proshares UltraPro Nasdaq Biotechnolog
SPLK=Splunk Inc.
FSZ=First Trust Switzerland AlphaDEX Fun
COLB=Columbia Banking System, Inc.
PYPL=PayPal Holdings, Inc.
ESCA=Escalade, Incorporated
GARS=Garrison Capital Inc.
AEZS=AEterna Zentaris Inc.
VXUS=Vanguard Total International Stock ET
FTSL=First Trust Senior Loan Fund ET
CPSS=Consumer Portfolio Services, Inc.
IACI=IAC/InterActiveCorp
SLAB=Silicon Laboratories, Inc.
QADB=QAD Inc.
HTBK=Heritage Commerce Corp
SNPS=Synopsys, Inc.
HDP=Hortonworks, Inc.
BAMM=Book
PIH=1347 Property Insurance Holdings, Inc.
ADHD=Alcobra Ltd.
FGBI=First Guaranty Bancshares, Inc.
AAPL=Apple Inc.
IDSA=Industrial Services of America, Inc.
IBOC=International Bancshares Corporation
LLTC=Linear Technology Corporation
TUSA=First Trust Total US Market AlphaDEX ET
RDVY=First Trust NASDAQ Rising Dividend Achievers ET
ACRS=Aclaris Therapeutics, Inc.
BLDR=Builders FirstSource, Inc.
ENSG=The Ensign Group, Inc.
ARNA=Arena Pharmaceuticals, Inc.
SYRX=Sysorex Global Holding Corp.
ARWAR=Arowana Inc.
JOEZ=Joe's Jeans Inc.
PLTM=First Trust ISE Global Platinum Index Fun
CRWS=Crown Crafts, Inc.
ENT=Global Eagle Entertainment Inc.
TSRA=Tessera Technologies, Inc.
GPIAW=GP Investments Acquisition Corp.
RESN=Resonant Inc.
SLVO=Credit Suisse AG
FOGO=Fogo de Chao, Inc.
CADTR=DT Asia Investments Limited
CENX=Century Aluminum Company
INFI=Infinity Pharmaceuticals, Inc.
CMCSA=Comcast Corporation
CHSCN=CHS Inc
BMRC=Bank of Marin Bancorp
PGC=Peapac
ACUR=Acura Pharmaceuticals, Inc.
ENZY=Enzymotec Ltd.
TIVO=TiVo Inc.
ATNI=Atlantic Tel
MPWR=Monolithic Power Systems, Inc.
NFBK=Northfield Bancorp, Inc.
UEPS=Net 1 UEPS Technologies, Inc.
CSF=Victory CEMP US Discovery Enhanced Volatility Wtd Index ET
ZNWAA=Zion Oil & Gas Inc
MLNX=Mellanox Technologies, Ltd.
BIS=ProShares UltraShort Nasdaq Biotechnolog
JIVE=Jive Software, Inc.
MGCD=MGC Diagnostics Corporation
GTWN=Georgetown Bancorp, Inc.
AGRX=Agile Therapeutics, Inc.
RPXC=RPX Corporation
ARLP=Alliance Resource Partners, L.P.
VCIT=Vanguard Intermediat
LPTN=Lpath, Inc.
NAII=Natural Alternatives International, Inc.
FWRD=Forward Air Corporation
EMCB=WisdomTree Emerging Markets Corporate Bond Fun
TRCH=Torchlight Energy Resources, Inc.
UAE=iShares MSCI UAE Capped ET
EMCG=WisdomTree Emerging Markets Consumer Growth Fun
CPAH=CounterPath Corporation
FCNCA=First Citizens BancShares, Inc.
DYAX=Dyax Corp.
PACW=PacWest Bancorp
SGBK=Stonegate Bank
GLNG=Golar LNG Limited
LJPC=La Jolla Pharmaceutical Company
SYNT=Syntel, Inc.
VBLT=Vascular Biogenics Ltd.
DEPO=Depomed, Inc.
PRIM=Primoris Services Corporation
NKSH=National Bankshares, Inc.
PRCP=Perceptron, Inc.
MLAB=Mesa Laboratories, Inc.
ANTH=Anthera Pharmaceuticals, Inc.
IXYS=IXYS Corporation
CADT=DT Asia Investments Limited
CASH=Meta Financial Group, Inc.
IDCC=InterDigital, Inc.
ACHN=Achillion Pharmaceuticals, Inc.
BRCD=Brocade Communications Systems, Inc.
ROBO=Rob
MIK=The Michaels Companies, Inc.
BPFHP=Boston Private Financial Holdings, Inc.
UHAL=Amerco
FSNN=Fusion Telecommunications International, Inc.
EIGI=Endurance International Group Holdings, Inc.
TROVW=TrovaGene, Inc.
DXCM=DexCom, Inc.
ZEUS=Olympic Steel, Inc.
SPPI=Spectrum Pharmaceuticals, Inc.
RPTP=Raptor Pharmaceutical Corp.
GLBL=TerraForm Global, Inc.
NTWK=NetSol Technologies Inc.
KBAL=Kimball International, Inc.
FXENP=FX Energy, Inc.
LBTYA=Liberty Global plc
THRX=Theravance, Inc.
ECAC=
LRAD=LRAD Corporation
PXS=Pyxis Tankers Inc.
LIND=Lindblad Expeditions Holdings Inc.
PAYX=Paychex, Inc.
EDGE=Edge Therapeutics, Inc.
TRTLW=Terrapin 3 Acquisition Corporation
DCTH=Delcath Systems, Inc.
TAPR=Barclays PLC
NBN=Northeast Bancorp
NEPT=Neptune Technologies & Bioresources Inc
ZBIO=ProShares UltraPro Short NASDAQ Biotechnolog
ANAD=ANADIGICS, Inc.
IQNT=Inteliquent, Inc.
YORW=The York Water Company
FIVN=Five9, Inc.
ICLN=iShares S&P Global Clean Energy Index Fun
FOX=Twent
QVCA=Liberty Interactive Corporation
IPXL=Impax Laboratories, Inc.
EMITF=Elbit Imaging Ltd.
KE=Kimball Electronics, Inc.
PNRG=PrimeEnergy Corporation
CRTN=Cartesian, Inc.
ARAY=Accuray Incorporated
BCRX=BioCryst Pharmaceuticals, Inc.
TATT=TAT Technologies Ltd.
VRSN=VeriSign, Inc.
ABCD=Cambium Learning Group, Inc.
SUMR=Summer Infant, Inc.
TSBK=Timberland Bancorp, Inc.
LE=Lands' End, Inc.
MNTX=Manitex International, Inc.
CDC=Victory CEMP US EQ Income Enhanced Volatility Wtd Index ET
WSTC=West Corporation
CBNK=Chicopee Bancorp, Inc.
OVAS=OvaScience Inc.
INFN=Infinera Corporation
LPNT=LifePoint Health, Inc.
NGHCZ=National General Holdings Corp
ACSF=American Capital Senior Floating, Ltd.
UDF=United Development Funding IV
BMRN=BioMarin Pharmaceutical Inc.
LITE=Lumentum Holdings Inc.
OLED=Universal Display Corporation
PATI=Patriot Transportation Holding, Inc.
ARCB=ArcBest Corporation
CELG=Celgene Corporation
IRG=Ignite Restaurant Group, Inc.
CTRN=Citi Trends, Inc.
ABGB=Abengoa, S.A.
DAIO=Data I/O Corporation
SBRA=Sabra Healthcare REIT, Inc.
MDM=Mountain Province Diamonds Inc.
SHLD=Sears Holdings Corporation
MBII=Marrone Bio Innovations, Inc.
SYMX=Synthesis Energy Systems, Inc.
VRTS=Virtus Investment Partners, Inc.
OPHC=OptimumBank Holdings, Inc.
SHLO=Shiloh Industries, Inc.
WYIGW=JM Global Holding Company
KURA=Kura Oncology, Inc.
BJRI=BJ's Restaurants, Inc.
SKYY=First Trust ISE Cloud Computing Index Fun
NCIT=NCI, Inc.
GALE=Galena Biopharma, Inc.
WFD=Westfield Financial, Inc.
SBRAP=Sabra Healthcare REIT, Inc.
CFA=Victory CEMP US 500 Volatility Wtd Index ET
IRCP=IRSA Propiedades Comerciales S.A.
POWI=Power Integrations, Inc.
ATRS=Antares Pharma, Inc.
NRIM=Northrim BanCorp Inc
EMMSP=Emmis Communications Corporation
FLN=First Trust Latin America AlphaDEX Fun
AAXJ=iShares MSCI All Country Asia ex Japan Index Fun
VRNT=Verint Systems Inc.
HTGM=HTG Molecular Diagnostics, Inc.
INTL=INTL FCStone Inc.
PRTA=Prothena Corporation plc
IRDMB=Iridium Communications Inc
SRSC=Sears Canada Inc.
PLXS=Plexus Corp.
NCLH=Norwegian Cruise Line Holdings Ltd.
MCRB=Seres Therapeutics, Inc.
CTSH=Cognizant Technology Solutions Corporation
SVVC=Firsthand Technology Value Fund, Inc.
SPKE=Spark Energy, Inc.
FCBC=First Community Bancshares, Inc.
PNRA=Panera Bread Company
MITL=Mitel Networks Corporation
COLL=Collegium Pharmaceutical, Inc.
EACQU=Easterly Acquisition Corp.
ISBC=Investors Bancorp, Inc.
OLLI=Ollie's Bargain Outlet Holdings, Inc.
WFBI=WashingtonFirst Bankshares Inc
GFNCP=General Finance Corporation
EBTC=Enterprise Bancorp Inc
BSPM=Biostar Pharmaceuticals, Inc.
CFMS=ConforMIS, Inc.
KELYB=Kelly Services, Inc.
RBPAA=Royal Bancshares of Pennsylvania, Inc.
CEVA=CEVA, Inc.
FDEF=First Defiance Financial Corp.
AVXL=Anavex Life Sciences Corp.
AMRK=
CSBR=Champions Oncology, Inc.
RDHL=Redhill Biopharma Ltd.
ARWAW=Arowana Inc.
ABMD=ABIOMED, Inc.
MRD=Memorial Resource Development Corp.
TAIT=Taitron Components Incorporated
CCXI=ChemoCentryx, Inc.
EZCH=EZchip Semiconductor Limited
ASND=Ascendis Pharma A/S
FSFG=First Savings Financial Group, Inc.
NILE=Blue Nile, Inc.
SBAC=SBA Communications Corporation
IESC=Integrated Electrical Services, Inc.
EACQW=Easterly Acquisition Corp.
UIHC=United Insurance Holdings Corp.
OSHC=Ocean Shore Holding Co.
ESIO=Electro Scientific Industries, Inc.
CFO=Victory CEMP US 500 Enhanced Volatility Wtd Index ET
INSY=Insys Therapeutics, Inc.
BKEPP=Blueknight Energy Partners L.P., L.L.C.
NMIH=NMI Holdings Inc
CENTA=Central Garden & Pet Company
WVE=WAVE Life Sciences Ltd.
SPRT=support.com, Inc.
CAVM=Cavium, Inc.
LMBS=First Trust Low Duration Mortgage Opportunities ET
NBRV=Nabriva Therapeutics AG
SMBC=Southern Missouri Bancorp, Inc.
ATAX=America First Multifamily Investors, L.P.
ACAS=American Capital, Ltd.
BNCN=BNC Bancorp
UCBI=United Community Banks, Inc.
EMIF=iShares S&P Emerging Markets Infrastructure Index Fun
ATLC=Atlanticus Holdings Corporation
LPSB=LaPorte Bancorp, Inc.
AWAY=HomeAway, Inc.
ROCK=Gibraltar Industries, Inc.
NBIX=Neurocrine Biosciences, Inc.
WMGIZ=Wright Medical Group N.V.
SMTX=SMTC Corporation
TRTLU=Terrapin 3 Acquisition Corporation
VGIT=Vanguard Intermediate
GRIF=Griffin Industrial Realty, Inc.
JCTCF=Jewet
CLRB=Cellectar Biosciences, Inc.
GENE=Genetic Technologies Ltd
SENEA=Seneca Foods Corp.
FNBC=First NBC Bank Holding Company
BPFHW=Boston Private Financial Holdings, Inc.
PLBC=Plumas Bancorp
STRZA=Starz
RPRX=Repros Therapeutics Inc.
MYL=Mylan N.V.
SCSC=ScanSource, Inc.
HMTV=Hemisphere Media Group, Inc.
BHACR=Barington/Hilco Acquisition Corp.
CCNE=CNB Financial Corporation
ASEI=American Science and Engineering, Inc.
RCII=Ren
GFED=Guaranty Federal Bancshares, Inc.
NTCT=NetScout Systems, Inc.
HDRA=Hydra Industries Acquisition Corp.
FWP=Forward Pharma A/S
PCRX=Pacira Pharmaceuticals, Inc.
WSFS=WSFS Financial Corporation
CHEKW=Chec
CNCE=Concert Pharmaceuticals, Inc.
ADRU=BLDRS Europe 100 ADR Index Fun
GMLP=Golar LNG Partners LP
COMM=CommScope Holding Company, Inc.
ACTA=Actua Corporation
FRED=Fred's, Inc.
DPRX=Dipexium Pharmaceuticals, Inc.
EMKR=EMCORE Corporation
MIFI=Novatel Wireless, Inc.
PRSC=The Providence Service Corporation
GRSHW=Gores Holdings, Inc.
DVCR=Diversicare Healthcare Services Inc.
CNXR=Connecture, Inc.
EWBC=East West Bancorp, Inc.
EXLS=ExlService Holdings, Inc.
SFM=Sprouts Farmers Market, Inc.
PCLN=The Priceline Group Inc.
MXIM=Maxim Integrated Products, Inc.
MICT=Micronet Enertec Technologies, Inc.
GBSN=Great Basin Scientific, Inc.
IDRA=Idera Pharmaceuticals, Inc.
DELT=Delta Technology Holdings Limited
REGN=Regeneron Pharmaceuticals, Inc.
CLDN=Celladon Corporation
MDCA=MDC Partners Inc.
ISIS=Isis Pharmaceuticals, Inc.
RILY=B. Riley Financial, Inc.
ZXZZT=NASDAQ TEST STOC
CBMX=CombiMatrix Corporation
MFNC=Mackinac Financial Corporation
MINI=Mobile Mini, Inc.
VRTU=Virtusa Corporation
MNOV=MediciNova, Inc.
OSTK=Overstock.com, Inc.
VIP=VimpelCom Ltd.
CRAY=Cray Inc
QQQX=Nuveen NASDAQ 100 Dynamic Overwrite Fund
UNXL=Un
PLAY=Dave & Buster's Entertainment, Inc.
HURN=Huron Consulting Group Inc.
FRAN=Francesca's Holdings Corporation
HMHC=Houghton Mifflin Harcourt Company
MRTN=Marten Transport, Ltd.
COOL=Majesco Entertainment Company
CSAL=Communications Sales & Leasing,Inc.
PRGN=Paragon Shipping Inc.
SGI=Silicon Graphics International Corp
EAGLU=Double Eagle Acquisition Corp.
NEOG=Neogen Corporation
PACEW=Pace Holdings Corp.
HAWK=Blackhawk Network Holdings, Inc.
KLAC=KL
WGBS=WaferGen Bi
CGNX=Cognex Corporation
PPC=Pilgrim's Pride Corporation
FITB=Fifth Third Bancorp
HCCI=Heritag
DTLK=Datalink Corporation
LARK=Landmark Bancorp Inc.
BIIB=Biogen Inc.
CDXS=Codexis, Inc.
VPCO=Vapor Corp.
BASI=Bioanalytical Systems, Inc.
REIS=Reis, Inc
DMND=Diamond Foods, Inc.
MBCN=Middlefield Banc Corp.
PBPB=Potbelly Corporation
TITN=Titan Machinery Inc.
BREW=Craft Brew Alliance, Inc.
PRXL=PAREXEL International Corporation
GPOR=Gulfport Energy Corporation
HIMX=Himax Technologies, Inc.
CNET=ChinaNet Online Holdings, Inc.
MCHX=Marchex, Inc.
WLRH=WL Ross Holding Corp.
SWIR=Sierra Wireless, Inc.
SLM=SLM Corporation
UBSH=Union Bankshares Corporation
LMCA=Liberty Media Corporation
SEED=Origin Agritech Limited
BIOL=Biolase, Inc.
ELNK=EarthLink Holdings Corp.
VONV=Vanguard Russell 1000 Value ET
DTUS=Barclays PLC
MSEX=Middlesex Water Company
UTHR=United Therapeutics Corporation
WOOD=iShares S&P Global Timber & Forestry Index Fun
CSBK=Clifton Bancorp Inc.
NECB=Northeast Community Bancorp, Inc.
BANF=BancFirst Corporation
SMMT=Summit Therapeutics plc
DXYN=The Dixie Group, Inc.
NTAP=NetApp, Inc.
IBKC=IBERIABANK Corporation
OPB=Opus Bank
RGLS=Regulus Therapeutics Inc.
RGEN=Repligen Corporation
CIL=Victory CEMP International Volatility Wtd Index ET
BOTJ=Bank of the James Financial Group, Inc.
VOD=Vodafone Group Plc
PWOD=Penns Woods Bancorp, Inc.
TBK=Triumph Bancorp, Inc.
SKLNU=Skyline Medical Inc.
PFBX=Peoples Financial Corporation
CSIQ=Canadian Solar Inc.
GLAD=Gladstone Capital Corporation
MRTX=Mirati Therapeutics, Inc.
BSQR=BSQUARE Corporation
EXTR=Extreme Networks, Inc.
FCFP=First Community Financial Partners, Inc.
VDTH=Videocon d2h Limited
HYLS=First Trust High Yield Long/Short ET
ACRX=AcelRx Pharmaceuticals, Inc.
HWCC=Houston Wire & Cable Company
TWIN=Twin Disc, Incorporated
FXEN=FX Energy, Inc.
PME=Pingtan Marine Enterprise Ltd.
HDNG=Hardinge, Inc.
SEV=Sevcon, Inc.
NEWT=Newtek Business Services Corp.
ESBK=Elmira Savings Bank NY (The)
TBRA=Tobira Therapeutics, Inc.
EGLE=Eagle Bulk Shipping Inc.
JTPY=JetPay Corporation
APDNW=Applied DNA Sciences Inc
AMRB=American River Bankshares
SCTY=SolarCity Corporation
MCRI=Monarch Casino & Resort, Inc.
IGOV=iShares S&P/Citigroup International Treasury Bond Fun
PMCS=PMC
COHR=Coherent, Inc.
AGFS=AgroFresh Solutions, Inc.
ZSAN=Zosano Pharma Corporation
PCO=Pendrell Corporation
FSLR=First Solar, Inc.
BCLI=Brainstorm Cell Therapeutics Inc.
WDC=Western Digital Corporation
GSM=Globe Specialty Metals Inc.
ASPS=Altisource Portfolio Solutions S.A.
SPOK=Spok Holdings, Inc.
PAACW=Pacific Special Acquisition Corp.
MATR=Mattersight Corporation
ALIM=Alimera Sciences, Inc.
YY=YY Inc.
MKTX=MarketAxess Holdings, Inc.
PSCF=PowerShares S&P SmallCap Financials Portfoli
BLVDW=Boulevard Acquisition Corp. II
ACWX=iShares MSCI ACWI ex US Index Fun
SAFM=Sanderson Farms, Inc.
HKTV=Hong Kong Television Network Limited
FLIC=The First of Long Island Corporation
TSRO=TESARO, Inc.
QVCB=Liberty Interactive Corporation
INBK=First Internet Bancorp
LIOX=Lionbridge Technologies, Inc.
CRUS=Cirrus Logic, Inc.
SNFCA=Security National Financial Corporation
ON=ON Semiconductor Corporation
EXA=Exa Corporation
ASRV=AmeriServ Financial Inc.
LAMR=Lamar Advertising Company
FDTS=First Trust Developed Markets e
SBFG=SB Financial Group, Inc.
GRMN=Garmin Ltd.
SKBI=Skystar Bi
GPP=Green Plains Partners LP
ESEA=Euroseas Ltd.
PBHC=Pathfinder Bancorp, Inc.
NVLS=Nivalis Therapeutics, Inc.
BELFB=Bel Fuse Inc.
SUPN=Supernus Pharmaceuticals, Inc.
CGEN=Compugen Ltd.
RPD=Rapid7, Inc.
SKIS=Peak Resorts, Inc.
NWBO=Northwest Biotherapeutics, Inc.
MESG=Xura, Inc.
ELGX=Endologix, Inc.
AGNCP=American Capital Agency Corp.
FDT=First Trust Developed Markets E
CNOB=ConnectOne Bancorp, Inc.
LVNTB=Liberty Interactive Corporation
TMUS=
DGAS=Delta Natural Gas Company, Inc.
COMT=iShares Commodities Select Strategy ET
AGII=Argo Group International Holdings, Ltd.
GASS=StealthGas, Inc.
PVTBP=PrivateBancorp, Inc.
ASCMA=Ascent Capital Group, Inc.
PRPH=ProPhase Labs, Inc.
PSIX=Power Solutions International, Inc.
CRIS=Curis, Inc.
COWNL=Cowen Group, Inc.
HAIN=The Hain Celestial Group, Inc.
JRJC=China Finance Online Co. Limited
AVNU=Avenue Financial Holdings, Inc.
AMPH=Amphastar Pharmaceuticals, Inc.
APDN=Applied DNA Sciences Inc
CBSH=Commerce Bancshares, Inc.
TVIX=Credit Suisse AG
TINY=Harris & Harris Group, Inc.
BVXV=BiondVax Pharmaceuticals Ltd.
PRGS=Progress Software Corporation
HFBL=Home Federal Bancorp, Inc. of Louisiana
KOOL=Cesca Therapeutics Inc.
IKGH=Iao Kun Group Holding Company Limited
ICUI=ICU Medical, Inc.
SIRI=Sirius XM Holdings Inc.
CVTI=Covenant Transportation Group, Inc.
MDWD=MediWound Ltd.
EXFO=EXFO Inc
PDCO=Patterson Companies, Inc.
QUMU=Qumu Corporation
ABUS=Arbutus Biopharma Corporation
SLCT=Select Bancorp, Inc.
OKSB=Southwest Bancorp, Inc.
CGO=Calamos Global Total Return Fund
DGLD=Credit Suisse AG
SOHOL=Sotherly Hotels LP
ADAP=Adaptimmune Therapeutics plc
VLGEA=Village Super Market, Inc.
KCAP=KCAP Financial, Inc.
CPHR=Cipher Pharmaceuticals Inc.
SOHU=Sohu.com Inc.
ROLL=RBC Bearings Incorporated
RDEN=Elizabeth Arden, Inc.
WEYS=Weyco Group, Inc.
VRML=Vermillion, Inc.
BEAV=B/E Aerospace, Inc.
WLRHW=WL Ross Holding Corp.
RIBTW=RiceBran Technologies
FSTR=L.B. Foster Company
BVA=Cordia Bancorp Inc.
OPGN=OpGen, Inc.
BKEP=Blueknight Energy Partners L.P., L.L.C.
MCHP=Microchip Technology Incorporated
STRZB=Starz
CTRE=CareTrust REIT, Inc.
AAON=AAON, Inc.
BKCC=BlackRock Capital Investment Corporation
JUNO=Juno Therapeutics, Inc.
GLRI=Glori Energy Inc
AXPW=Axion Power International, Inc.
FBSS=Fauquier Bankshares, Inc.
CUNB=CU Bancorp (CA)
GLPG=Galapagos NV
MOSY=MoSys, Inc.
MSON=MISONIX, Inc.
PSAU=PowerShares Global Gold & Precious Metals Portfoli
CERS=Cerus Corporation
USBI=United Security Bancshares, Inc.
JYNT=The Joint Corp.
VRNG=Vringo, Inc.
NXST=Nexstar Broadcasting Group, Inc.
ABY=Abengoa Yield plc
HAFC=Hanmi Financial Corporation
ARIS=ARI Network Services, Inc.
PPSI=Pioneer Power Solutions, Inc.
VONE=Vanguard Russell 1000 ET
VASC=Vascular Solutions, Inc.
EVBS=Eastern Virginia Bankshares, Inc.
FFKT=Farmers Capital Bank Corporation
PGLC=Pershing Gold Corporation
FLAG=WeatherStorm Forensic Accounting Long Short ET
EEI=Ecology and Environment, Inc.
SAJA=Sajan, Inc.
LTRX=Lantronix, Inc.
CWCO=Consolidated Water Co. Ltd.
CROX=Crocs, Inc.
WOOF=VCA Inc.
ISCA=International Speedway Corporation
MDAS=MedAssets, Inc.
MHLD=Maiden Holdings, Ltd.
FNGN=Financial Engines, Inc.
ANIP=ANI Pharmaceuticals, Inc.
AEGN=Aegion Corp
ZIONW=Zions Bancorporation
PTLA=Portola Pharmaceuticals, Inc.
DXGE=WisdomTree Germany Hedged Equity Fun
FMBI=First Midwest Bancorp, Inc.
SPEX=Spherix Incorporated
GPIAU=GP Investments Acquisition Corp.
CHW=Calamos Global Dynamic Income Fund
IBKR=Interactive Brokers Group, Inc.
SIRO=Sirona Dental Systems, Inc.
GTIM=Good Times Restaurants Inc.
PSTB=Park Sterling Corporation
ABAX=ABAXIS, Inc.
MPEL=Melco Crown Entertainment Limited
ADRE=BLDRS Emerging Markets 50 ADR Index Fun
SONA=Southern National Bancorp of Virginia, Inc.
TISA=Top Image Systems, Ltd.
PAAS=Pan American Silver Corp.
PETX=Aratana Therapeutics, Inc.
OBAS=Optibase Ltd.
TIL=Till Capital Ltd.
HIBB=Hibbett Sports, Inc.
OSN=Ossen Innovation Co., Ltd.
AERI=Aerie Pharmaceuticals, Inc.
TCBIL=Texas Capital Bancshares, Inc.
CASY=Caseys General Stores, Inc.
LLNW=Limelight Networks, Inc.
CBOE=CBOE Holdings, Inc.
III=Information Services Group, Inc.
LONG=eLong, Inc.
GGAL=Grupo Financiero Galicia S.A.
VPCOU=Vapor Corp.
BEAT=BioTelemetry, Inc.
IRIX=IRIDEX Corporation
IFON=InfoSonics Corp
CETV=Central European Media Enterprises Ltd.
JAKK=JAKKS Pacific, Inc.
BPOPN=Popular, Inc.
PSMT=PriceSmart, Inc.
SGNT=Sagent Pharmaceuticals, Inc.
CCOI=Cogent Communications Holdings, Inc.
PSCI=PowerShares S&P SmallCap Industrials Portfoli
ALDX=Aldeyra Therapeutics, Inc.
NGHCO=National General Holdings Corp
UBND=WisdomTree Western Asset Unconstrained Bond Fun
HAS=Hasbro, Inc.
APIC=Apigee Corporation
RPRXW=Repros Therapeutics Inc.
ESPR=Esperion Therapeutics, Inc.
ISM=SLM Corporation
WIN=Windstream Holdings, Inc.
BVXVW=BiondVax Pharmaceuticals Ltd.
FFHL=Fuwei Films (Holdings) Co., Ltd.
ICLR=ICON plc
CYBR=CyberArk Software Ltd.
OCRX=Ocera Therapeutics, Inc.
ENTA=Enanta Pharmaceuticals, Inc.
LIME=Lime Energy Co.
MZOR=Mazor Robotics Ltd.
BLMN=Bloomin' Brands, Inc.
FOXA=Twent
PSCE=PowerShares S&P SmallCap Energy Portfoli
APEI=American Public Education, Inc.
HGSH=China HGS Real Estate, Inc.
COYN=COPsync, Inc.
AMNB=American National Bankshares, Inc.
AGIO=Agios Pharmaceuticals, Inc.
CTSO=Cytosorbents Corporation
GLRE=Greenlight Reinsurance, Ltd.
PRFT=Perficient, Inc.
LOPE=Grand Canyon Education, Inc.
YPRO=AdvisorShares YieldPro ET
JBSS=John B. Sanfilippo & Son, Inc.
QQQ=PowerShares QQQ Trust, Series
QRVO=Qorvo, Inc.
SINO=Sin
TTHI=Transition Therapeutics, Inc.
TBPH=Theravance Biopharma, Inc.
NUAN=Nuance Communications, Inc.
GRPN=Groupon, Inc.
LKQ=LKQ Corporation
ACWI=iShares MSCI ACWI Index Fun
NYMTP=New York Mortgage Trust, Inc.
AMD=Advanced Micro Devices, Inc.
ENTL=Entellus Medical, Inc.
BDMS=Birner Dental Management Services, Inc.
FES=Forbes Energy Services Ltd
NYMX=Nymox Pharmaceutical Corporation
ACTS=Actions Semiconductor Co., Ltd.
STDY=SteadyMed Ltd.
MDRX=Allscripts Healthcare Solutions, Inc.
ARTX=Arotech Corporation
PFPT=Proofpoint, Inc.
HLIT=Harmonic Inc.
INCR=INC Research Holdings, Inc.
ESXB=Community Bankers Trust Corporation.
WVFC=WVS Financial Corp.
VBTX=Veritex Holdings, Inc.
SCOR=comScore, Inc.
OXBRW=Oxbridge Re Holdings Limited
ASBB=ASB Bancorp, Inc.
JKHY=Jack Henry & Associates, Inc.
HSON=Hudson Global, Inc.
PEBK=Peoples Bancorp of North Carolina, Inc.
QCCO=QC Holdings, Inc.
EARS=Auris Medical Holding AG
ZG=Zillow Group, Inc.
NVCN=Neovasc Inc.
FUNC=First United Corporation
FNTCU=FinTech Acquisition Corp.
LBRDK=Liberty Broadband Corporation
GLDD=Great Lakes Dredge & Dock Corporation
CSOD=Cornerstone OnDemand, Inc.
PAACR=Pacific Special Acquisition Corp.
INDB=Independent Bank Corp.
CYNO=Cynosure, Inc.
XGTIW=XG Technology, Inc
COLM=Columbia Sportswear Company
CREG=China Recycling Energy Corporation
PRGNL=Paragon Shipping Inc.
ACNB=ACNB Corporation
FNFG=First Niagara Financial Group Inc.
VIAV=Viavi Solutions Inc.
FOLD=Amicus Therapeutics, Inc.
HSIC=Henry Schein, Inc.
GMCR=Keurig Green Mountain, Inc.
FLEX=Flextronics International Ltd.
MNKD=MannKind Corporation
ZINC=Horsehead Holding Corp.
ACET=Aceto Corporation
ECACR=
WSBF=Waterstone Financial, Inc.
LBRDA=Liberty Broadband Corporation
ORIT=Oritani Financial Corp.
NAME=Rightside Group, Ltd.
AMSG=Amsurg Corp.
CIFC=CIFC Corp.
PRAA=PRA Group, Inc.
COST=Costco Wholesale Corporation
GNCA=Genocea Biosciences, Inc.
PLPC=Preformed Line Products Company
ABTX=Allegiance Bancshares, Inc.
CAC=Camden National Corporation
CDTX=Cidara Therapeutics, Inc.
HRMN=Harmony Merger Corp.
CSWI=CSW Industrials, Inc.
YCB=Your Community Bankshares, Inc.
ASTI=Ascent Solar Technologies, Inc.
XOMA=XOMA Corporation
TRS=TriMas Corporation
VVUS=VIVUS, Inc.
AHPI=Allied Healthcare Products, Inc.
FEIC=FEI Company
ERW=Janus Equal Risk Weighted Large Cap ET
VBND=Vident Core U.S. Bond Strategy Fun
OCAT=Ocata Therapeutics, Inc.
CMCSK=Comcast Corporation
GPAC=Global Partner Acquisition Corp.
TAXI=Medallion Financial Corp.
HBK=Hamilton Bancorp, Inc.
VRNS=Varonis Systems, Inc.
LBIO=Lion Biotechnologies, Inc.
ICPT=Intercept Pharmaceuticals, Inc.
INNL=Innocoll AG
QQQC=Global X NASDAQ China Technology ET
FULT=Fulton Financial Corporation
BLPH=Bellerophon Therapeutics, Inc.
NCOM=National Commerce Corporation
AKRX=Akorn, Inc.
KLXI=KLX Inc.
AMBC=Ambac Financial Group, Inc.
CARO=Carolina Financial Corporation
CPHD=CEPHEID
FEM=First Trust Emerging Markets AlphaDEX Fun
PRAH=PRA Health Sciences, Inc.
CBFV=CB Financial Services, Inc.
SPHS=Sophiris Bio, Inc.
ABCO=The Advisory Board Company
CECE=CECO Environmental Corp.
VALX=Validea Market Legends ET
PCYO=Pure Cycle Corporation
SFXE=SFX Entertainment, Inc.
MU=Micron Technology, Inc.
MVIS=Microvision, Inc.
KALU=Kaiser Aluminum Corporation
ALXN=Alexion Pharmaceuticals, Inc.
WBKC=Wolverine Bancorp, Inc.
XNPT=XenoPort, Inc.
EDGW=Edgewater Technology, Inc.
GOGO=Gogo Inc.
SBNY=Signature Bank
GILD=Gilead Sciences, Inc.
NTGR=NETGEAR, Inc.
CHSCP=CHS Inc
PPBI=Pacific Premier Bancorp Inc
CMCO=Columbus McKinnon Corporation
HBIO=Harvard Bioscience, Inc.
MICTW=Micronet Enertec Technologies, Inc.
PLUG=Plug Power, Inc.
BBC=BioShares Biotechnology Clinical Trials Fun
CPLP=Capital Product Partners L.P.
PATK=Patrick Industries, Inc.
AMSC=American Superconductor Corporation
SPCB=SuperCom, Ltd.
SIEB=Siebert Financial Corp.
VXDN=AccuShares Spot CBOE VIX Down Share
VRTX=Vertex Pharmaceuticals Incorporated
GOOD=Gladstone Commercial Corporation
SHLDW=Sears Holdings Corporation
CNSL=Consolidated Communications Holdings, Inc.
WLDN=Willdan Group, Inc.
DBVT=DBV Technologies S.A.
INOD=Innodata Inc.
RDWR=Radware Ltd.
DCOM=Dime Community Bancshares, Inc.
SEAC=SeaChange International, Inc.
DRWIW=DragonWave Inc
MEILW=Methes Energies International Ltd
FULLL=Full Circle Capital Corporation
DYSL=Dynasil Corporation of America
WHF=WhiteHorse Finance, Inc.
CPRT=Copart, Inc.
NATR=Nature's Sunshine Products, Inc.
WHLM=Wilhelmina International, Inc.
WHLRP=Wheeler Real Estate Investment Trust, Inc.
CYRXW=CryoPort, Inc.
MARK=Remark Media, Inc.
ISIL=Intersil Corporation
BBRG=Bravo Brio Restaurant Group, Inc.
KIRK=Kirkland's, Inc.
DTYS=Barclays PLC
EVOL=Evolving Systems, Inc.
SGMA=SigmaTron International, Inc.
ARII=American Railcar Industries, Inc.
FITBI=Fifth Third Bancorp
SIVBO=SVB Financial Group
ELEC=Electrum Special Acquisition Corporation
CFNL=Cardinal Financial Corporation
XIV=Credit Suisse AG
NTRS=Northern Trust Corporation
ACFC=Atlantic Coast Financial Corporation
NVMI=Nova Measuring Instruments Ltd.
VNRBP=Vanguard Natural Resources LLC
FRGI=Fiesta Restaurant Group, Inc.
ULTR=Ultrapetrol (Bahamas) Limited
PUB=People's Utah Bancorp
IKNX=Ikonics Corporation
IFV=First Trust Dorsey Wright International Focus 5 ET
MTSI=M/
TIPT=Tiptree Financial Inc.
PPHMP=Peregrine Pharmaceuticals Inc.
ALKS=Alkermes plc
BVSN=BroadVision, Inc.
PXLW=Pixelworks, Inc.
NSSC=NAPCO Security Technologies, Inc.
PDFS=PDF Solutions, Inc.
CYRN=CYREN Ltd.
PSEM=Pericom Semiconductor Corporation
CERE=Ceres, Inc.
HALO=Halozyme Therapeutics, Inc.
PDVW=pdvWireless, Inc.
CXDC=China XD Plastics Company Limited
FEMB=First Trust Emerging Markets Local Currency Bond ET
OCLR=Oclaro, Inc.
RLJE=RLJ Entertainment, Inc.
BCOM=B Communications Ltd.
FOMX=Foamix Pharmaceuticals Ltd.
ELON=Echelon Corporation
AUMAW=AR Capital Acquisition Corp.
TCFC=The Community Financial Corporation
TILE=Interface, Inc.
MEOH=Methanex Corporation
SCVL=Shoe Carnival, Inc.
OTEL=Otelco Inc.
ARGS=Argos Therapeutics, Inc.
LSBG=Lake Sunapee Bank Group
GERN=Geron Corporation
WBB=Westbury Bancorp, Inc.
BGFV=Big 5 Sporting Goods Corporation
SRET=Global X SuperDividend REIT ET
ONVI=Onvia, Inc.
QLC=FlexShares US Quality Large Cap Index Fun
IDXX=IDEXX Laboratories, Inc.
CPSI=Computer Programs and Systems, Inc.
ARWR=Arrowhead Research Corporation
TVIZ=Credit Suisse AG
PSTI=Pluristem Therapeutics, Inc.
TGEN=Tecogen Inc.
RRGB=Red Robin Gourmet Burgers, Inc.
JBHT=J.B. Hunt Transport Services, Inc.
ACTG=Acacia Research Corporation
TRVN=Trevena, Inc.
ROIA=Radio One, Inc.
ENDP=Endo International plc
TNAV=Telenav, Inc.
NRX=NephroGenex, Inc.
TRIB=Trinity Biotech plc
PRTK=Paratek Pharmaceuticals, Inc.
MBFI=MB Financial Inc.
CBNJ=Cape Bancorp, Inc.
ROYL=Royale Energy, Inc.
WTBA=West Bancorporation
HNH=Handy & Harman Ltd.
TYPE=Monotype Imaging Holdings Inc.
SBLKL=Star Bulk Carriers Corp.
CTIB=CTI Industries Corporation
FCA=First Trust China AlphaDEX Fun
PFIS=Peoples Financial Services Corp.
FTCS=First Trust Capital Strength ET
WABC=Westamerica Bancorporation
QGEN=Qiagen N.V.
ELTK=Eltek Ltd.
UTSI=UTStarcom Holdings Corp
PRMW=Primo Water Corporation
AVAV=AeroVironment, Inc.
FISI=Financial Institutions, Inc.
VIA=Viacom Inc.
STRL=Sterling Construction Company Inc
EAGL=Double Eagle Acquisition Corp.
ROVI=Rovi Corporation
CSPI=CSP Inc.
CIVBP=Civista Bancshares, Inc.
SAGE=Sage Therapeutics, Inc.
AHGP=Alliance Holdings GP, L.P.
DXPS=WisdomTree United Kingdom Hedged Equity Fun
ACHC=Acadia Healthcare Company, Inc.
IMI=Intermolecular, Inc.
NDSN=Nordson Corporation
TSLA=Tesla Motors, Inc.
VTHR=Vanguard Russell 3000 ET
WINS=Wins Finance Holdings Inc.
VECO=Veeco Instruments Inc.
MMLP=Martin Midstream Partners L.P.
EGHT=8x8 Inc
WHLR=Wheeler Real Estate Investment Trust, Inc.
KUTV=Ku6 Media Co., Ltd.
MTBCP=Medical Transcription Billing, Corp.
BBGI=Beasley Broadcast Group, Inc.
SGEN=Seattle Genetics, Inc.
MKTO=Marketo, Inc.
LNDC=Landec Corporation
IPKW=PowerShares International BuyBack Achievers Portfoli
PTEN=Patterso
IIN=IntriCon Corporation
MELI=MercadoLibre, Inc.
ECPG=Encore Capital Group Inc
KFRC=Kforce, Inc.
GIII=
PFIE=Profire Energy, Inc.
HBHC=Hancock Holding Company
CDNA=CareDx, Inc.
KINS=Kingstone Companies, Inc
HNSN=Hansen Medical, Inc.
LMRK=Landmark Infrastructure Partners LP
TRTL=Terrapin 3 Acquisition Corporation
ELECU=Electrum Special Acquisition Corporation
KEYW=The KEYW Holding Corporation
SBBX=Sussex Bancorp
MBTF=M B T Financial Corp
HEOP=Heritage Oaks Bancorp
QCOM=QUALCOMM Incorporated
CARZ=First Trust NASDAQ Global Auto Index Fun
NWS=News Corporation
CTWS=Connecticut Water Service, Inc.
JAXB=Jacksonville Bancorp, Inc.
FB=Facebook, Inc.
BDGE=Bridge Bancorp, Inc.
AVHI=A V Homes, Inc.
DGLY=Digital Ally, Inc.
PTSI=P.A.M. Transportation Services, Inc.
COKE=Coc
OMAB=Grupo Aeroportuario del Centro Norte S.A.B. de C.V.
SWHC=Smith & Wesson Holding Corporation
LRCX=Lam Research Corporation
MANT=ManTech International Corporation
CHEV=Cheviot Financial Corp
WFM=Whole Foods Market, Inc.
ONEQ=Fidelity Nasdaq Composite Index Tracking Stoc
PIRS=Pieris Pharmaceuticals, Inc.
SPWH=Sportsman's Warehouse Holdings, Inc.
AVID=Avid Technology, Inc.
LWAY=Lifeway Foods, Inc.
PCMI=PCM, Inc.
DOX=Amdocs Limited
LKOR=FlexShares Credi
STCK=Stock Building Supply Holdings, Inc.
HURC=Hurco Companies, Inc.
VWR=VWR Corporation
AMZN=Amazon.com, Inc.
HOFT=Hooker Furniture Corporation
JSM=SLM Corporation
BLUE=bluebird bio, Inc.
EPRS=EPIRUS Biopharmaceuticals, Inc.
LINDW=Lindblad Expeditions Holdings Inc.
ALOG=Analogic Corporation
VTL=Vital Therapies, Inc.
SANW=S&W Seed Company
QQXT=First Trust NASDA
NXTDW=NX
MRCY=Mercury Systems Inc
LILA=Liberty Global plc
OXGN=OXiGENE, Inc.
ORMP=Oramed Pharmaceuticals Inc.
ARKR=Ark Restaurants Corp.
ARCW=ARC Group Worldwide, Inc.
COWN=Cowen Group, Inc.
OHAI=OHA Investment Corporation
HZNP=Horizon Pharma plc
HPJ=Highpower International Inc
MTSN=Mattson Technology, Inc.
FTLB=First Trust Low Beta Income ET
EPAY=Bottomline Technologies, Inc.
STBA=S&T Bancorp, Inc.
CVCO=Cavco Industries, Inc.
SFBS=ServisFirst Bancshares, Inc.
SLRC=Solar Capital Ltd.
POPE=Pope Resources
CRVL=CorVel Corp.
OMER=Omeros Corporation
MTGEP=American Capital Mortgage Investment Corp.
IPCC=Infinity Property and Casualty Corporation
ORIG=Ocean Rig UDW Inc.
BICK=First Trust BICK Index Fun
KPTI=Karyopharm Therapeutics Inc.
GSOL=Global Sources Ltd.
IBCP=Independent Bank Corporation
VALU=Value Line, Inc.
FBIO=Fortress Biotech, Inc.
LENS=Presbia PLC
ADRA=BLDRS Asia 50 ADR Index Fun
IROQ=IF Bancorp, Inc.
IDSY=I.D. Systems, Inc.
FRPT=Freshpet, Inc.
ZNGA=Zynga Inc.
DFRG=Del Frisco's Restaurant Group, Inc.
RADA=Rada Electronics Industries Limited
IEP=Icahn Enterprises L.P.
SIFI=SI Financial Group, Inc.
WHLRW=Wheeler Real Estate Investment Trust, Inc.
PLUS=ePlus inc.
NSYS=Nortech Systems Incorporated
RWLK=ReWalk Robotics Ltd
TBBK=The Bancorp, Inc.
DSLV=Credit Suisse AG
PRTS=U.S. Auto Parts Network, Inc.
RIBT=RiceBran Technologies
MNRO=Monro Muffler Brake, Inc.
IRMD=iRadimed Corporation
RBCN=Rubicon Technology, Inc.
CHLN=China Housing & Land Development, Inc.
ADI=Analog Devices, Inc.
TNGO=Tangoe, Inc.
MHLDO=Maiden Holdings, Ltd.
BWLD=Buffalo Wild Wings, Inc.
EGT=Entertainment Gaming Asia Incorporated
CVV=CVD Equipment Corporation
MSTR=MicroStrategy Incorporated
LOGI=Logitech International S.A.
PAACU=Pacific Special Acquisition Corp.
DGRW=WisdomTree U.S. Quality Dividend Growth Fun
DJCO=Daily Journal Corp. (S.C.)
CLIR=ClearSign Combustion Corporation
LSBK=Lake Shore Bancorp, Inc.
SLP=Simulations Plus, Inc.
KRNY=Kearny Financial
FBNC=First Bancorp
FATE=Fate Therapeutics, Inc.
DLBS=Barclays PLC
PTX=Pernix Therapeutics Holdings, Inc.
WILC=G. Will
EVLV=EVINE Live Inc.
CSGP=CoStar Group, Inc.
MSFG=MainSource Financial Group, Inc.
HWBK=Hawthorn Bancshares, Inc.
PVBC=Provident Bancorp, Inc.
VNRCP=Vanguard Natural Resources LLC
SGOC=SGOCO Group, Ltd
RVNC=Revance Therapeutics, Inc.
GEVO=Gevo, Inc.
QKLS=QKL Stores, Inc.
WIX=Wix.com Ltd.
ALDR=Alder BioPharmaceuticals, Inc.
CALL=magicJack VocalTec Ltd
GBLIZ=Global Indemnity plc
EGBN=Eagle Bancorp, Inc.
SHIP=Seanergy Maritime Holdings Corp
GOODN=Gladstone Commercial Corporation
PBSK=Poage Bankshares, Inc.
WSBC=WesBanco, Inc.
RP=RealPage, Inc.
FTD=FTD Companies, Inc.
PDCE=PDC Energy, Inc.
CDL=Victory CEMP US Large Cap High Div Volatility Wtd Index ET
PTXP=PennTex Midstream Partners, LP
SCHN=Schnitzer Steel Industries, Inc.
SQBG=Sequential Brands Group, Inc.
GAME=Shanda Games Limited
FBZ=First Trust Brazil AlphaDEX Fun
EBIX=Ebix, Inc.
CBPO=China Biologic Products, Inc.
BWINB=Baldwin & Lyons, Inc.
BIDU=Baidu, Inc.
OCC=Optical Cable Corporation
MPB=Mid Penn Bancorp
EEMA=iShares MSCI Emerging Markets Asia Index Fun
THST=Truet
CTMX=CytomX Therapeutics, Inc.
YHOO=Yahoo! Inc.
UNFI=United Natural Foods, Inc.
RGLD=Royal Gold, Inc.
MBSD=FlexShares Disciplined Duration MBS Index Fun
CALD=Callidus Software, Inc.
TAST=Carrols Restaurant Group, Inc.
SYKE=Sykes Enterprises, Incorporated
REXI=Resource America, Inc.
ERS=Empire Resources, Inc.
RSTI=Rofi
ALXA=Alexza Pharmaceuticals, Inc.
USLB=PowerShares Russell 1000 Low Beta Equal Weight Portfoli
FCFS=First Cash Financial Services, Inc.
PCTY=Paylocity Holding Corporation
MORN=Morningstar, Inc.
MIRN=Mirna Therapeutics, Inc.
ORBK=Orbotech Ltd.
QCRH=QCR Holdings, Inc.
RPRXZ=Repros Therapeutics Inc.
LOB=Live Oak Bancshares, Inc.
ISRL=Isramco, Inc.
IIJI=Internet Initiative Japan, Inc.
NVFY=Nova Lifestyle, Inc
QUIK=QuickLogic Corporation
SRCLP=Stericycle, Inc.
FWM=Fairway Group Holdings Corp.
AIRT=Air T, Inc.
SGMO=Sangamo BioSciences, Inc.
OGXI=OncoGenex Pharmaceuticals Inc.
DNBF=DNB Financial Corp
GNCMA=General Communication, Inc.
RAIL=Freightcar America, Inc.
CALA=Calithera Biosciences, Inc.
ASTC=Astrotech Corporation
ONFC=Oneida Financial Corp.
ARTW=Art'
WMGI=Wright Medical Group N.V.
HA=Hawaiian Holdings, Inc.
CDORO=Condor Hospitality Trust, Inc.
HTLD=Heartland Express, Inc.
LMNR=Limoneira Co
CYCC=Cyclacel Pharmaceuticals, Inc.
AMDA=Amedica Corporation
STXS=Stereotaxis, Inc.
NEOT=Neothetics, Inc.
FORR=Forrester Research, Inc.
DIOD=Diodes Incorporated
OPXA=Opexa Therapeutics, Inc.
VICL=Vical Incorporated
OPGNW=OpGen, Inc.
HMNY=Helios and Matheson Analytics Inc
GLUU=Glu Mobile Inc.
GBLI=Global Indemnity plc
TGLS=Tecnoglass Inc.
LGIH=LGI Homes, Inc.
CATM=Cardtronics, Inc.
CCCR=China Commercial Credit, Inc.
GOOG=Alphabet Inc.
MESO=Mesoblast Limited
MOLG=MOL Global, Inc.
SENEB=Seneca Foods Corp.
RITT=RIT Technologies Ltd.
SBFGP=SB Financial Group, Inc.
WBA=Walgreens Boots Alliance, Inc.
AMTX=Aemetis, Inc
WAVX=Wave Systems Corp.
MOMO=Momo Inc.
VKTX=Viking Therapeutics, Inc.
NATH=Nathan's Famous, Inc.
BANR=Banner Corporation
ATHN=athenahealth, Inc.
BOSC=B.O.S. Better Online Solutions
VDSI=VASCO Data Security International, Inc.
SOHOM=Sotherly Hotels LP
IPDN=Professional Diversity Network, Inc.
PAAC=Pacific Special Acquisition Corp.
CRTO=Criteo S.A.
PAHC=Phibro Animal Health Corporation
TESS=TESSCO Technologies Incorporated
MDVX=Medovex Corp.
NFEC=NF Energy Saving Corporation
CRNT=Ceragon Networks Ltd.
DGRE=WisdomTree Emerging Markets Quality Dividend Growth Fun
LGCYO=Legacy Reserves LP
AAOI=Applied Optoelectronics, Inc.
CFGE=Calamos Focus Growth ET
CSUN=China Sunergy Co., Ltd.
PDEX=Pr
IMMU=Immunomedics, Inc.
HALL=Hallmark Financial Services, Inc.
OCLSW=Oculus Innovative Sciences, Inc.
COVS=Covisint Corporation
TFM=The Fresh Market, Inc.
QUNR=Qunar Cayman Islands Limited
PCYG=Park City Group, Inc.
DENN=Denny's Corporation
MGIC=Magic Software Enterprises Ltd.
ADP=Automatic Data Processing, Inc.
SRCL=Stericycle, Inc.
USLM=United States Lime & Minerals, Inc.
SKUL=Skullcandy, Inc.
GNMA=iShares GNMA Bond ET
MDVXW=Medovex Corp.
ATEC=Alphatec Holdings, Inc.
SNCR=Synchronoss Technologies, Inc.
BSTC=BioSpecifics Technologies Corp
SBUX=Starbucks Corporation
TQQQ=ProShares UltraPro QQ
ADSK=Autodesk, Inc.
CBLI=Cleveland BioLabs, Inc.
